//MAP CONVERTED BY dmm2tgm.py THIS HEADER COMMENT PREVENTS RECONVERSION, DO NOT REMOVE
"c" = (
/turf/open/floor/plating/ground/mars/random/cave,
/area/bigredv2/caves/southwest)
"d" = (
/obj/effect/landmark/fog_blocker/xeno_spawn,
/turf/closed/mineral/smooth/bigred,
/area/bigredv2/caves/rock)
"f" = (
/obj/effect/landmark/weed_node,
/obj/effect/landmark/xeno_resin_wall,
/turf/open/floor/plating/ground/mars/random/cave,
/area/bigredv2/caves/southwest)
"i" = (
/obj/effect/landmark/weed_node,
/turf/open/floor/plating/ground/mars/random/cave,
/area/bigredv2/caves/southwest)
"p" = (
/obj/effect/ai_node,
/turf/open/floor/plating/ground/mars/random/cave/rock,
/area/bigredv2/caves/southwest)
"q" = (
/obj/effect/landmark/xeno_resin_wall,
/turf/open/floor/plating/ground/mars/random/cave,
/area/bigredv2/caves/southwest)
"r" = (
/obj/effect/landmark/excavation_site_spawner,
/turf/open/floor/plating/ground/mars/random/cave,
/area/bigredv2/caves/southwest)
"t" = (
/obj/effect/ai_node,
/turf/open/floor/plating/ground/mars/random/cave,
/area/bigredv2/caves/southwest)
"u" = (
/turf/open/floor/plating/ground/mars/random/cave/rock,
/area/bigredv2/caves/southwest)
"w" = (
/obj/effect/landmark/fog_blocker,
/turf/closed/mineral/smooth/bigred,
/area/bigredv2/caves/rock)
"A" = (
/obj/effect/landmark/weed_node,
/turf/open/floor/plating/ground/mars/random/cave/rock,
/area/bigredv2/caves/southwest)
"E" = (
/obj/effect/landmark/xeno_resin_wall,
/turf/open/floor/plating/ground/mars/random/cave/rock,
/area/bigredv2/caves/southwest)
"F" = (
/obj/effect/landmark/excavation_site_spawner,
/obj/effect/ai_node,
/turf/open/floor/plating/ground/mars/random/cave,
/area/bigredv2/caves/southwest)
"I" = (
/obj/effect/landmark/weed_node,
/obj/effect/ai_node,
/turf/open/floor/plating/ground/mars/random/cave,
/area/bigredv2/caves/southwest)
"K" = (
/turf/closed/mineral/smooth/bigred/indestructible,
/area/space)
"L" = (
/obj/effect/landmark/xeno_tunnel_spawn,
/turf/open/floor/plating/ground/mars/random/cave,
/area/bigredv2/caves/southwest)
"M" = (
/obj/effect/landmark/weed_node,
/obj/effect/landmark/weed_node,
/turf/open/floor/plating/ground/mars/random/cave,
/area/bigredv2/caves/southwest)
"N" = (
/obj/effect/landmark/fog_blocker,
/turf/open/floor/plating/ground/mars/random/cave,
/area/bigredv2/caves/southwest)
"Q" = (
/turf/closed/mineral/smooth/bigred,
/area/bigredv2/caves/rock)
"S" = (
/obj/effect/landmark/xeno_silo_spawn,
/turf/open/floor/plating/ground/mars/random/cave,
/area/bigredv2/caves/southwest)
"U" = (
/obj/effect/landmark/xeno_resin_door,
/turf/open/floor/plating/ground/mars/random/cave,
/area/bigredv2/caves/southwest)
"V" = (
/obj/effect/landmark/fog_blocker/xeno_spawn,
/turf/open/floor/plating/ground/mars/random/cave,
/area/bigredv2/caves/southwest)

(1,1,1) = {"
K
K
K
K
K
K
K
K
K
K
K
K
K
K
K
K
K
K
K
K
K
K
K
K
K
K
K
K
K
K
K
K
K
K
K
K
K
K
K
K
K
K
K
"}
(2,1,1) = {"
Q
Q
Q
Q
Q
Q
Q
Q
Q
Q
Q
Q
Q
Q
Q
Q
Q
Q
Q
Q
Q
Q
Q
Q
Q
Q
Q
Q
Q
Q
Q
Q
Q
Q
Q
Q
Q
Q
Q
Q
Q
Q
K
"}
(3,1,1) = {"
Q
Q
Q
Q
Q
Q
Q
Q
Q
Q
Q
Q
Q
Q
Q
Q
Q
Q
Q
Q
Q
Q
Q
Q
Q
Q
Q
Q
d
d
d
d
d
d
d
d
d
d
d
d
Q
Q
K
"}
(4,1,1) = {"
Q
Q
Q
Q
Q
Q
Q
Q
Q
Q
Q
Q
Q
Q
Q
Q
Q
Q
Q
Q
Q
Q
Q
Q
Q
Q
Q
Q
d
Q
Q
Q
Q
Q
Q
Q
Q
Q
Q
d
Q
Q
K
"}
(5,1,1) = {"
Q
Q
Q
Q
Q
Q
Q
Q
Q
Q
Q
Q
Q
Q
Q
Q
Q
Q
Q
Q
Q
Q
Q
Q
Q
Q
Q
Q
d
Q
Q
Q
Q
Q
c
c
t
i
Q
d
Q
Q
K
"}
(6,1,1) = {"
Q
Q
Q
Q
Q
Q
Q
Q
Q
Q
Q
Q
Q
Q
Q
Q
Q
Q
Q
Q
Q
Q
Q
Q
Q
Q
Q
Q
d
Q
Q
Q
Q
c
c
c
S
c
c
d
Q
Q
K
"}
(7,1,1) = {"
Q
Q
Q
Q
c
c
c
c
c
Q
Q
Q
Q
Q
Q
Q
Q
Q
Q
Q
Q
Q
Q
Q
Q
Q
Q
c
V
c
E
Q
c
i
c
c
c
c
i
d
Q
Q
K
"}
(8,1,1) = {"
Q
Q
c
c
c
i
u
c
c
c
c
Q
Q
Q
Q
Q
Q
c
c
c
c
u
c
c
c
c
c
c
V
c
E
c
c
c
c
c
c
c
L
d
Q
Q
K
"}
(9,1,1) = {"
Q
c
u
c
c
c
c
c
c
c
c
c
c
c
c
c
c
c
c
c
c
c
c
c
c
c
i
c
V
c
E
c
i
c
c
c
i
c
Q
d
Q
Q
K
"}
(10,1,1) = {"
c
c
t
c
i
i
c
c
i
c
i
t
c
c
c
c
c
t
c
c
c
c
t
c
c
c
c
t
V
c
U
u
c
t
i
c
t
c
Q
d
Q
Q
K
"}
(11,1,1) = {"
i
c
c
c
c
c
i
c
u
c
c
c
c
u
u
c
c
c
c
u
c
c
c
i
c
c
c
c
V
c
U
u
i
c
c
c
c
Q
Q
d
Q
Q
K
"}
(12,1,1) = {"
c
c
c
c
c
c
c
c
c
c
Q
Q
Q
c
c
c
u
c
c
c
c
c
c
c
c
c
c
c
V
c
q
c
c
c
Q
Q
Q
Q
Q
d
Q
Q
K
"}
(13,1,1) = {"
c
u
p
Q
Q
Q
Q
Q
Q
Q
Q
Q
Q
Q
c
c
c
t
c
c
c
c
i
c
c
c
i
c
V
c
q
f
q
q
Q
Q
Q
Q
Q
d
Q
Q
K
"}
(14,1,1) = {"
c
c
u
Q
Q
Q
Q
Q
Q
Q
Q
Q
Q
Q
Q
Q
Q
Q
c
c
c
c
c
c
c
c
c
c
V
c
c
c
c
c
u
Q
Q
Q
Q
d
Q
Q
K
"}
(15,1,1) = {"
c
c
c
u
u
Q
Q
Q
Q
Q
Q
Q
Q
Q
Q
Q
Q
Q
Q
Q
c
c
c
c
c
c
i
c
V
V
V
V
V
V
V
d
d
d
d
d
Q
Q
K
"}
(16,1,1) = {"
c
c
M
c
u
Q
Q
Q
Q
Q
Q
Q
Q
Q
Q
Q
Q
Q
Q
Q
c
c
t
i
c
c
c
t
c
c
c
c
t
c
c
Q
Q
Q
Q
Q
Q
Q
K
"}
(17,1,1) = {"
c
i
c
c
u
Q
Q
Q
Q
Q
Q
Q
Q
Q
Q
Q
Q
Q
Q
Q
c
c
c
c
c
c
r
c
c
c
c
c
c
c
u
Q
Q
Q
Q
Q
Q
Q
K
"}
(18,1,1) = {"
c
c
c
c
u
Q
Q
Q
Q
Q
Q
Q
Q
Q
Q
Q
Q
Q
Q
c
c
c
c
c
c
c
c
i
c
c
M
c
c
Q
Q
Q
Q
Q
Q
Q
Q
Q
K
"}
(19,1,1) = {"
c
i
t
c
p
Q
Q
Q
Q
Q
Q
Q
Q
Q
Q
Q
Q
c
c
u
c
c
i
c
c
c
c
c
i
c
u
c
c
Q
Q
Q
Q
Q
Q
Q
Q
Q
K
"}
(20,1,1) = {"
Q
c
c
c
i
u
Q
Q
Q
Q
Q
Q
Q
Q
Q
c
c
c
i
c
c
c
c
c
c
A
c
c
c
c
u
c
c
c
Q
Q
Q
Q
Q
Q
Q
Q
K
"}
(21,1,1) = {"
Q
Q
Q
c
c
u
Q
Q
Q
Q
Q
u
c
c
c
c
c
u
c
c
c
c
i
c
c
c
c
c
c
u
c
c
I
c
Q
Q
Q
Q
Q
Q
Q
Q
K
"}
(22,1,1) = {"
Q
Q
Q
i
c
c
u
c
Q
Q
Q
c
t
c
c
i
c
c
c
c
c
c
t
u
Q
u
c
c
c
u
Q
Q
c
t
i
c
t
Q
Q
Q
Q
Q
K
"}
(23,1,1) = {"
Q
Q
Q
c
c
c
c
c
c
Q
c
c
c
c
c
u
Q
Q
Q
Q
Q
Q
Q
Q
Q
c
c
t
Q
Q
Q
Q
Q
c
c
c
i
Q
Q
Q
Q
Q
K
"}
(24,1,1) = {"
Q
Q
Q
c
c
i
c
c
u
c
c
u
c
i
c
u
Q
Q
Q
Q
Q
Q
Q
Q
c
c
c
c
Q
Q
Q
Q
Q
c
u
c
c
c
c
Q
Q
Q
K
"}
(25,1,1) = {"
Q
Q
Q
u
c
c
c
i
c
c
A
c
c
c
c
Q
Q
Q
Q
Q
Q
Q
Q
Q
c
I
c
c
Q
Q
Q
Q
Q
Q
c
c
c
c
c
c
Q
Q
K
"}
(26,1,1) = {"
Q
Q
Q
Q
t
c
c
c
c
c
c
i
u
c
c
Q
Q
Q
Q
Q
Q
Q
Q
Q
Q
c
t
c
Q
Q
Q
Q
Q
Q
Q
c
c
c
A
c
Q
Q
K
"}
(27,1,1) = {"
Q
Q
Q
c
i
t
c
c
c
c
c
c
t
c
c
Q
Q
Q
Q
Q
Q
Q
Q
Q
Q
c
c
i
c
Q
Q
Q
Q
Q
Q
c
c
c
c
c
Q
Q
K
"}
(28,1,1) = {"
Q
Q
c
c
c
c
c
c
c
c
c
c
i
c
u
Q
Q
Q
Q
Q
Q
Q
Q
Q
Q
Q
c
c
c
Q
Q
Q
Q
Q
Q
c
A
c
i
c
Q
Q
K
"}
(29,1,1) = {"
Q
Q
c
c
c
c
c
i
c
c
c
c
c
i
c
Q
Q
Q
Q
Q
Q
Q
Q
Q
Q
Q
c
i
c
Q
Q
Q
Q
Q
Q
c
c
c
c
c
Q
Q
K
"}
(30,1,1) = {"
Q
Q
c
i
c
c
c
c
i
u
Q
u
t
c
c
c
Q
Q
Q
Q
Q
Q
Q
Q
Q
Q
c
i
c
c
Q
Q
Q
t
i
c
t
c
c
Q
Q
Q
K
"}
(31,1,1) = {"
Q
c
c
c
c
c
c
c
c
u
Q
Q
u
t
i
c
c
Q
Q
Q
Q
Q
Q
Q
Q
Q
p
c
c
c
c
c
c
c
c
c
Q
Q
Q
Q
Q
Q
K
"}
(32,1,1) = {"
Q
c
t
c
c
t
Q
c
c
u
Q
Q
Q
c
t
c
c
t
c
Q
Q
Q
Q
Q
Q
Q
u
p
i
c
c
i
c
c
Q
Q
Q
Q
Q
Q
Q
Q
K
"}
(33,1,1) = {"
Q
c
c
c
Q
Q
Q
u
u
Q
Q
Q
Q
c
c
c
i
c
i
c
u
Q
Q
Q
Q
Q
Q
u
t
c
c
c
c
t
Q
K
K
K
K
K
K
K
K
"}
(34,1,1) = {"
Q
c
c
c
Q
Q
Q
Q
Q
Q
Q
Q
Q
Q
c
c
c
c
c
c
c
u
Q
Q
Q
Q
Q
Q
c
i
c
c
c
Q
Q
K
K
K
K
K
K
K
K
"}
(35,1,1) = {"
Q
c
c
Q
Q
Q
Q
Q
Q
Q
Q
Q
Q
c
c
c
c
c
c
c
u
Q
Q
Q
Q
Q
Q
Q
c
c
c
Q
Q
Q
Q
K
K
K
K
K
K
K
K
"}
(36,1,1) = {"
Q
c
c
Q
Q
Q
Q
Q
Q
Q
Q
Q
Q
u
t
c
c
t
i
c
u
Q
Q
Q
Q
Q
Q
Q
c
i
c
Q
Q
Q
Q
K
K
K
K
K
K
K
K
"}
(37,1,1) = {"
c
c
c
Q
Q
Q
Q
Q
Q
Q
Q
Q
Q
Q
Q
Q
c
F
c
c
c
p
Q
Q
Q
Q
Q
Q
c
r
c
Q
Q
Q
Q
K
K
K
K
K
K
K
K
"}
(38,1,1) = {"
c
c
c
Q
Q
Q
Q
Q
Q
Q
Q
Q
Q
Q
Q
Q
c
c
c
c
c
u
Q
Q
Q
Q
u
A
c
i
c
Q
Q
Q
Q
K
K
K
K
K
K
K
K
"}
(39,1,1) = {"
c
c
c
Q
Q
Q
Q
Q
Q
Q
Q
Q
Q
Q
Q
Q
u
c
c
c
c
u
Q
Q
Q
Q
u
u
c
c
Q
Q
Q
Q
Q
K
K
K
K
K
K
K
K
"}
(40,1,1) = {"
c
i
c
Q
Q
Q
Q
Q
Q
Q
Q
Q
Q
Q
Q
Q
Q
Q
Q
i
i
c
u
u
Q
Q
Q
Q
t
c
Q
Q
Q
Q
Q
K
K
K
K
K
K
K
K
"}
(41,1,1) = {"
N
N
N
w
w
w
w
w
w
w
w
w
w
w
Q
Q
Q
Q
Q
c
c
c
c
u
Q
Q
Q
Q
c
i
Q
Q
Q
Q
Q
K
K
K
K
K
K
K
K
"}
