//MAP CONVERTED BY dmm2tgm.py THIS HEADER COMMENT PREVENTS RECONVERSION, DO NOT REMOVE
"ab" = (
/obj/effect/landmark/weed_node,
/obj/effect/ai_node,
/turf/open/floor/plating/ground/mars/random/cave,
/area/bigredv2/caves/southwest)
"ac" = (
/obj/effect/landmark/excavation_site_spawner,
/turf/open/floor/plating/ground/mars/random/cave,
/area/bigredv2/caves/southwest)
"ad" = (
/obj/effect/landmark/fog_blocker,
/turf/open/floor/plating/ground/mars/random/cave,
/area/bigredv2/caves/southwest)
"ae" = (
/turf/open/floor/plating/ground/mars/random/cave/rock,
/area/bigredv2/caves/southwest)
"af" = (
/turf/open/floor/plating/ground/mars/random/cave,
/area/bigredv2/caves/southwest)
"ah" = (
/obj/effect/ai_node,
/turf/open/floor/plating/ground/mars/random/cave/rock,
/area/bigredv2/caves/southwest)
"ai" = (
/obj/effect/landmark/weed_node,
/obj/effect/landmark/weed_node,
/turf/open/floor/plating/ground/mars/random/cave,
/area/bigredv2/caves/southwest)
"aj" = (
/obj/effect/landmark/weed_node,
/turf/open/floor/plating/ground/mars/random/cave/rock,
/area/bigredv2/caves/southwest)
"ak" = (
/obj/effect/landmark/xeno_silo_spawn,
/turf/open/floor/plating/ground/mars/random/cave,
/area/bigredv2/caves/southwest)
"am" = (
/obj/effect/ai_node,
/turf/open/floor/plating/ground/mars/random/cave,
/area/bigredv2/caves/southwest)
"an" = (
/obj/effect/landmark/excavation_site_spawner,
/obj/effect/landmark/fog_blocker/xeno_spawn,
/turf/open/floor/plating/ground/mars/random/cave,
/area/bigredv2/caves/southwest)
"aq" = (
/obj/effect/landmark/fog_blocker,
/turf/closed/mineral/smooth/bigred,
/area/bigredv2/caves/rock)
"ar" = (
/obj/effect/landmark/xeno_resin_wall,
/turf/open/floor/plating/ground/mars/random/cave,
/area/bigredv2/caves/southwest)
"as" = (
/obj/effect/landmark/excavation_site_spawner,
/obj/effect/ai_node,
/turf/open/floor/plating/ground/mars/random/cave,
/area/bigredv2/caves/southwest)
"au" = (
/turf/closed/mineral/smooth/bigred/indestructible,
/area/space)
"aw" = (
/obj/effect/landmark/fog_blocker/xeno_spawn,
/turf/open/floor/plating/ground/mars/random/cave/rock,
/area/bigredv2/caves/southwest)
"az" = (
/obj/effect/landmark/fog_blocker/xeno_spawn,
/turf/open/floor/plating/ground/mars/random/cave,
/area/bigredv2/caves/southwest)
"aF" = (
/obj/effect/landmark/weed_node,
/obj/effect/landmark/xeno_resin_wall,
/turf/open/floor/plating/ground/mars/random/cave,
/area/bigredv2/caves/southwest)
"aH" = (
/turf/closed/mineral/smooth/bigred,
/area/bigredv2/caves/rock)
"aI" = (
/obj/effect/landmark/xeno_resin_door,
/turf/open/floor/plating/ground/mars/random/cave,
/area/bigredv2/caves/southwest)
"aJ" = (
/obj/effect/landmark/weed_node,
/obj/effect/landmark/fog_blocker/xeno_spawn,
/turf/open/floor/plating/ground/mars/random/cave,
/area/bigredv2/caves/southwest)
"aQ" = (
/obj/effect/landmark/weed_node,
/turf/open/floor/plating/ground/mars/random/cave,
/area/bigredv2/caves/southwest)
"aT" = (
/obj/effect/landmark/fog_blocker/xeno_spawn,
/turf/closed/mineral/smooth/bigred,
/area/bigredv2/caves/rock)
"hG" = (
/obj/effect/landmark/xeno_tunnel_spawn,
/turf/open/floor/plating/ground/mars/random/cave/rock,
/area/bigredv2/caves/southwest)

(1,1,1) = {"
au
au
au
au
au
au
au
au
au
au
au
au
au
au
au
au
au
au
au
au
au
au
au
au
au
au
au
au
au
au
au
au
au
au
au
au
au
au
au
au
au
au
au
"}
(2,1,1) = {"
aH
aH
aH
aH
aH
aH
aH
aH
aH
aH
aH
aH
aH
aH
aH
aH
aH
aH
aH
aT
aH
aH
aH
aH
aH
aH
aH
aH
aH
aH
aH
aH
aH
aH
aH
au
au
au
au
au
au
au
au
"}
(3,1,1) = {"
aH
aH
aH
aH
aH
aH
aH
aH
aH
aH
aH
aH
aH
aH
aH
aH
aH
aH
aH
aT
aH
aH
aH
aH
aH
aH
aH
aH
aH
aH
aH
aH
aH
aH
aH
au
au
au
au
au
au
au
au
"}
(4,1,1) = {"
aH
aH
aH
aH
aH
aH
aH
aH
aH
aH
aH
aH
aH
aH
aH
aH
aH
aH
aH
aT
aH
aH
aH
aH
aH
aH
aH
aH
aH
aH
aH
aH
aH
aH
aH
au
au
au
au
au
au
au
au
"}
(5,1,1) = {"
aH
aH
aH
aH
aH
aH
aH
aH
aH
aH
aH
aH
aH
aH
aH
aH
aH
aH
aH
aT
aH
aH
aH
aH
aH
aH
aH
aH
aH
aH
aH
aH
aH
aH
aH
au
au
au
au
au
au
au
au
"}
(6,1,1) = {"
aH
aH
aH
aH
aH
aH
aH
aH
aH
aH
aH
aH
aH
aH
aH
aH
aH
aH
aH
aT
aH
aH
af
ae
ae
hG
ae
ae
aH
aH
aH
aH
aH
aH
aH
au
au
au
au
au
au
au
au
"}
(7,1,1) = {"
aH
aH
aH
aH
af
af
af
af
af
aH
aH
aH
aH
aH
aH
aj
af
af
af
az
af
ar
af
af
af
af
af
af
ae
aH
aH
aH
aH
aH
aH
au
au
au
au
au
au
au
au
"}
(8,1,1) = {"
aH
aH
af
af
af
aQ
af
af
af
af
af
aH
aH
aH
ae
af
af
af
af
aJ
af
ar
af
af
aQ
af
aQ
af
ae
aH
aH
aH
aH
aH
aH
au
au
au
au
au
au
au
au
"}
(9,1,1) = {"
aH
af
af
af
af
af
af
af
af
af
af
af
af
af
af
af
af
af
af
az
af
ar
af
af
af
ak
af
af
aj
aH
aH
aH
aH
aH
aH
au
au
au
au
au
au
au
au
"}
(10,1,1) = {"
af
af
am
af
aQ
aQ
af
af
aQ
af
aQ
am
af
af
af
am
af
af
af
az
af
ar
af
af
aQ
am
af
aQ
af
ae
aH
aH
aH
aH
aH
au
au
au
au
au
au
au
au
"}
(11,1,1) = {"
aQ
af
af
af
af
af
aQ
af
af
af
af
af
af
af
af
af
af
af
aQ
az
af
aF
af
af
af
af
af
af
af
ae
aH
aH
aH
aH
aH
au
au
au
au
au
au
au
au
"}
(12,1,1) = {"
af
af
af
af
af
af
af
af
aH
aH
aH
af
af
af
af
af
af
af
af
az
af
ar
af
af
af
af
af
af
af
af
af
af
aH
aH
aH
au
au
au
au
au
au
au
au
"}
(13,1,1) = {"
af
af
aH
aH
aH
aH
aH
aH
aH
aH
aH
af
af
af
af
aQ
af
af
af
az
af
ar
ar
ar
ar
aI
aI
ar
ar
aF
ar
ar
aH
aH
aH
au
au
au
au
au
au
au
au
"}
(14,1,1) = {"
af
aH
aH
aH
aH
aH
aH
aH
aH
aH
aH
af
af
af
af
af
af
af
af
az
af
af
af
af
af
af
af
ae
af
af
af
aH
aH
aH
aH
au
au
au
au
au
au
au
au
"}
(15,1,1) = {"
aH
aH
aH
aH
aH
aH
aH
aH
aH
aH
aH
ae
af
af
af
af
af
af
af
aJ
af
af
af
af
af
af
af
af
af
af
aQ
aH
aH
aH
aH
au
au
au
au
au
au
au
au
"}
(16,1,1) = {"
aH
aH
aH
aH
aH
aH
aH
aH
aH
aH
aH
aH
af
af
af
am
aQ
af
af
az
am
af
af
af
af
am
af
af
aQ
af
af
aH
aH
aH
aH
au
au
au
au
au
au
au
au
"}
(17,1,1) = {"
aH
aH
aH
aH
aH
aH
aH
aH
aH
aH
aH
aH
af
af
af
af
af
af
af
an
az
az
az
az
az
az
az
aw
az
az
az
aT
aT
aT
aT
au
au
au
au
au
au
au
au
"}
(18,1,1) = {"
aH
aH
aH
aH
aH
aH
aH
aH
aH
aH
aH
aH
af
af
aQ
af
af
af
af
af
aQ
af
af
ai
af
af
af
af
af
af
aH
aH
aH
aH
aH
au
au
au
au
au
au
au
au
"}
(19,1,1) = {"
aH
aH
aH
aH
aH
aH
aH
aH
aH
aH
aH
aH
af
af
af
af
af
af
af
af
af
aQ
af
ae
aQ
af
af
af
aH
aH
aH
aH
aH
aH
aH
au
au
au
au
au
au
au
au
"}
(20,1,1) = {"
aH
aH
aH
aH
aH
aH
aH
aH
aH
aH
af
ae
af
af
af
af
af
af
af
af
af
af
af
ae
af
af
af
aH
aH
aH
aH
aH
aH
aH
aH
au
au
au
au
au
au
au
au
"}
(21,1,1) = {"
aH
aH
aH
aH
aH
aH
aH
aH
aH
af
af
ae
af
af
af
aQ
af
af
af
aQ
af
af
ae
af
af
aQ
af
aH
aH
aH
aH
aH
aH
aH
aH
au
au
au
au
au
au
au
au
"}
(22,1,1) = {"
aH
aH
aH
aH
aH
aH
aH
aH
aH
af
af
af
am
af
af
am
ae
aH
ae
af
af
af
ae
aH
aH
af
af
aH
aH
aH
aH
aH
aH
aH
aH
au
au
au
au
au
au
au
au
"}
(23,1,1) = {"
aH
aH
aH
aH
aH
aH
aH
aH
af
af
af
af
af
af
af
ae
aH
aH
aH
aH
aH
aH
aH
aH
aH
af
af
af
aH
aH
aH
aH
aH
aH
aH
au
au
au
au
au
au
au
au
"}
(24,1,1) = {"
aH
aH
aH
aH
aH
aQ
af
af
ae
af
af
ae
af
aQ
af
ae
aH
aH
aH
aH
aH
aH
aH
aH
af
af
af
af
aH
aH
aH
aH
aH
aH
aH
au
au
au
au
au
au
au
au
"}
(25,1,1) = {"
aH
aH
aH
aH
aH
af
af
aQ
af
af
aj
af
af
af
af
aH
aH
aH
aH
aH
aH
aH
aH
aH
af
ab
af
af
aH
aH
aH
aH
aH
aH
aH
au
au
au
au
au
au
au
au
"}
(26,1,1) = {"
aH
aH
aH
aH
am
af
af
af
af
af
af
aQ
ae
af
af
aH
aH
aH
aH
aH
aH
aH
aH
aH
aH
af
am
af
aH
aH
aH
aH
aH
aH
aH
au
au
au
au
au
au
au
au
"}
(27,1,1) = {"
aH
aH
aH
af
aQ
am
af
af
af
af
af
af
am
af
af
aH
aH
aH
aH
aH
aH
aH
aH
aH
aH
af
af
aQ
af
aH
aH
aH
aH
aH
aH
au
au
au
au
au
au
au
au
"}
(28,1,1) = {"
aH
aH
af
af
af
af
af
af
af
af
af
af
aQ
af
ae
aH
aH
aH
aH
aH
aH
aH
aH
aH
aH
aH
af
af
af
aH
aH
aH
aH
aH
aH
au
au
au
au
au
au
au
au
"}
(29,1,1) = {"
aH
aH
af
af
af
af
af
aQ
af
af
af
af
af
aQ
af
aH
aH
aH
aH
aH
aH
aH
aH
aH
aH
aH
af
aQ
af
aH
aH
aH
aH
aH
aH
au
au
au
au
au
au
au
au
"}
(30,1,1) = {"
aH
aH
af
aQ
af
af
af
af
aQ
ae
aH
ae
am
af
af
af
aH
aH
aH
aH
aH
aH
aH
aH
aH
aH
af
aQ
af
af
aH
aH
aH
aH
aH
au
au
au
au
au
au
au
au
"}
(31,1,1) = {"
aH
af
af
af
af
af
af
af
af
ae
aH
aH
ae
am
aQ
af
af
aH
aH
aH
aH
aH
aH
aH
aH
aH
ah
af
af
af
aH
aH
aH
aH
aH
au
au
au
au
au
au
au
au
"}
(32,1,1) = {"
aH
af
am
af
af
am
aH
af
af
ae
aH
aH
aH
af
am
af
af
am
af
aH
aH
aH
aH
aH
aH
aH
ae
ah
aQ
af
aH
aH
aH
aH
aH
au
au
au
au
au
au
au
au
"}
(33,1,1) = {"
aH
af
af
af
aH
aH
aH
ae
ae
aH
aH
aH
aH
af
af
af
aQ
af
aQ
af
ae
aH
aH
aH
aH
aH
aH
ae
am
af
af
aH
aH
aH
aH
au
au
au
au
au
au
au
au
"}
(34,1,1) = {"
aH
af
af
af
aH
aH
aH
aH
aH
aH
aH
aH
aH
aH
af
af
af
af
af
af
af
ae
aH
aH
aH
aH
aH
aH
af
af
af
af
aH
aH
aH
au
au
au
au
au
au
au
au
"}
(35,1,1) = {"
aH
af
af
aH
aH
aH
aH
aH
aH
aH
aH
aH
aH
af
af
af
af
af
af
af
ae
aH
aH
aH
aH
aH
aH
aH
af
af
af
aH
aH
aH
aH
au
au
au
au
au
au
au
au
"}
(36,1,1) = {"
aH
af
af
aH
aH
aH
aH
aH
aH
aH
aH
aH
aH
ae
af
af
af
af
aQ
af
ae
aH
aH
aH
aH
aH
aH
aH
af
aQ
af
aH
aH
aH
aH
au
au
au
au
au
au
au
au
"}
(37,1,1) = {"
af
af
af
aH
aH
aH
aH
aH
aH
aH
aH
aH
aH
aH
aH
aH
af
as
af
af
af
ah
aH
aH
aH
aH
aH
aH
af
ac
af
aH
aH
aH
aH
au
au
au
au
au
au
au
au
"}
(38,1,1) = {"
af
af
af
aH
aH
aH
aH
aH
aH
aH
aH
aH
aH
aH
aH
aH
af
af
af
af
af
ae
aH
aH
aH
aH
ae
aj
af
aQ
af
aH
aH
aH
aH
au
au
au
au
au
au
au
au
"}
(39,1,1) = {"
af
af
af
aH
aH
aH
aH
aH
aH
aH
aH
aH
aH
aH
aH
aH
ae
af
af
af
af
ae
aH
aH
aH
aH
ae
ae
af
af
aH
aH
aH
aH
aH
au
au
au
au
au
au
au
au
"}
(40,1,1) = {"
af
aQ
af
aH
aH
aH
aH
aH
aH
aH
aH
aH
aH
aH
aH
aH
aH
aH
aH
aQ
aQ
af
ae
ae
aH
aH
aH
aH
af
af
aH
aH
aH
aH
aH
au
au
au
au
au
au
au
au
"}
(41,1,1) = {"
ad
ad
ad
aq
aq
aq
aq
aq
aq
aq
aq
aq
aq
aq
aH
aH
aH
aH
aH
af
af
af
af
ae
aH
aH
aH
aH
af
aQ
aH
aH
aH
aH
aH
au
au
au
au
au
au
au
au
"}
