//MAP CONVERTED BY dmm2tgm.py THIS HEADER COMMENT PREVENTS RECONVERSION, DO NOT REMOVE
"d" = (
/obj/effect/landmark/excavation_site_spawner,
/obj/effect/ai_node,
/turf/open/floor/plating/ground/mars/random/cave,
/area/bigredv2/caves/southwest)
"f" = (
/turf/closed/mineral/smooth/bigred,
/area/bigredv2/caves/rock)
"g" = (
/obj/effect/landmark/fog_blocker/xeno_spawn,
/turf/open/floor/plating/ground/mars/random/cave,
/area/bigredv2/caves/southwest)
"h" = (
/obj/effect/landmark/weed_node,
/turf/open/floor/plating/ground/mars/random/cave,
/area/bigredv2/caves/southwest)
"j" = (
/turf/open/floor/plating/ground/mars/random/cave,
/area/bigredv2/caves/southwest)
"l" = (
/obj/effect/landmark/xeno_resin_door,
/turf/open/floor/plating/ground/mars/random/cave,
/area/bigredv2/caves/southwest)
"n" = (
/turf/closed/mineral/smooth/bigred/indestructible,
/area/space)
"p" = (
/obj/effect/landmark/weed_node,
/turf/open/floor/plating/ground/mars/random/cave/rock,
/area/bigredv2/caves/southwest)
"t" = (
/obj/effect/landmark/weed_node,
/obj/effect/landmark/weed_node,
/turf/open/floor/plating/ground/mars/random/cave,
/area/bigredv2/caves/southwest)
"u" = (
/obj/effect/landmark/excavation_site_spawner,
/turf/open/floor/plating/ground/mars/random/cave,
/area/bigredv2/caves/southwest)
"w" = (
/turf/open/floor/plating/ground/mars/random/cave/rock,
/area/bigredv2/caves/southwest)
"x" = (
/obj/effect/landmark/fog_blocker/xeno_spawn,
/turf/open/floor/plating/ground/mars/random/cave/rock,
/area/bigredv2/caves/southwest)
"y" = (
/obj/effect/landmark/weed_node,
/obj/effect/landmark/fog_blocker/xeno_spawn,
/turf/open/floor/plating/ground/mars/random/cave,
/area/bigredv2/caves/southwest)
"F" = (
/obj/effect/landmark/xeno_silo_spawn,
/turf/open/floor/plating/ground/mars/random/cave,
/area/bigredv2/caves/southwest)
"G" = (
/obj/effect/landmark/fog_blocker,
/turf/open/floor/plating/ground/mars/random/cave,
/area/bigredv2/caves/southwest)
"I" = (
/obj/effect/landmark/fog_blocker/xeno_spawn,
/turf/closed/mineral/smooth/bigred,
/area/bigredv2/caves/rock)
"J" = (
/obj/effect/landmark/weed_node,
/obj/effect/ai_node,
/turf/open/floor/plating/ground/mars/random/cave,
/area/bigredv2/caves/southwest)
"K" = (
/obj/effect/landmark/xeno_tunnel_spawn,
/turf/open/floor/plating/ground/mars/random/cave,
/area/bigredv2/caves/southwest)
"P" = (
/obj/effect/landmark/fog_blocker,
/turf/closed/mineral/smooth/bigred,
/area/bigredv2/caves/rock)
"U" = (
/obj/effect/ai_node,
/turf/open/floor/plating/ground/mars/random/cave/rock,
/area/bigredv2/caves/southwest)
"W" = (
/obj/effect/ai_node,
/turf/open/floor/plating/ground/mars/random/cave,
/area/bigredv2/caves/southwest)

(1,1,1) = {"
n
n
n
n
n
n
n
n
n
n
n
n
n
n
n
n
n
n
n
n
n
n
n
n
n
n
n
n
n
n
n
n
n
n
n
n
n
n
n
n
n
n
n
"}
(2,1,1) = {"
f
f
f
f
f
f
f
f
f
f
f
f
f
I
f
f
f
f
f
f
f
f
f
f
f
f
f
f
f
f
f
f
f
f
f
n
n
n
n
n
n
n
n
"}
(3,1,1) = {"
f
f
f
f
f
f
f
f
f
f
f
f
f
I
f
f
f
f
f
f
f
f
f
f
f
f
f
f
f
f
f
f
f
f
f
n
n
n
n
n
n
n
n
"}
(4,1,1) = {"
f
f
f
f
f
f
f
f
f
f
f
f
f
I
f
f
f
f
f
f
f
f
f
f
f
f
f
f
f
f
f
f
f
f
f
n
n
n
n
n
n
n
n
"}
(5,1,1) = {"
f
f
f
f
f
f
f
f
f
f
f
f
f
I
f
f
f
f
f
f
f
f
j
j
j
j
j
f
f
f
f
f
f
f
f
n
n
n
n
n
n
n
n
"}
(6,1,1) = {"
f
f
f
f
f
f
f
f
f
f
f
f
f
I
f
f
f
j
w
w
w
w
w
j
h
j
j
j
f
f
f
f
f
f
f
n
n
n
n
n
n
n
n
"}
(7,1,1) = {"
f
f
f
f
j
j
W
j
j
f
f
f
f
I
j
p
l
j
j
j
j
j
j
j
j
j
F
j
f
f
f
f
f
f
f
n
n
n
n
n
n
n
n
"}
(8,1,1) = {"
f
f
j
h
j
h
j
j
h
j
j
f
f
g
U
j
l
j
j
h
j
h
W
j
j
j
j
W
j
f
f
f
f
f
f
n
n
n
n
n
n
n
n
"}
(9,1,1) = {"
f
j
j
j
j
j
j
j
j
j
j
j
j
g
j
j
l
j
j
j
j
j
j
h
j
j
j
j
j
f
f
f
f
f
f
n
n
n
n
n
n
n
n
"}
(10,1,1) = {"
j
j
W
j
h
h
W
j
h
j
h
W
j
y
W
f
f
f
f
f
j
j
j
j
j
j
j
j
j
f
f
f
f
f
f
n
n
n
n
n
n
n
n
"}
(11,1,1) = {"
h
j
j
j
j
j
h
j
j
j
j
j
j
g
j
f
f
f
f
f
f
f
j
K
w
j
j
h
j
f
f
f
f
f
f
n
n
n
n
n
n
n
n
"}
(12,1,1) = {"
j
j
j
j
j
j
j
j
j
j
f
f
f
g
j
j
f
f
f
f
f
f
f
f
j
j
j
j
j
f
f
f
f
f
f
n
n
n
n
n
n
n
n
"}
(13,1,1) = {"
j
w
U
f
f
f
f
f
f
f
f
f
f
g
j
h
j
f
f
f
f
f
f
f
j
j
j
j
j
f
f
f
f
f
f
n
n
n
n
n
n
n
n
"}
(14,1,1) = {"
j
j
w
f
f
f
f
f
f
f
f
f
f
g
j
j
j
j
j
f
f
f
f
f
f
j
j
w
f
f
f
f
f
f
f
n
n
n
n
n
n
n
n
"}
(15,1,1) = {"
h
j
j
w
w
f
f
f
f
f
f
f
f
x
W
j
j
j
j
h
f
f
f
f
f
j
j
j
f
f
f
f
f
f
f
n
n
n
n
n
n
n
n
"}
(16,1,1) = {"
j
j
t
j
w
f
f
f
f
f
f
f
f
I
j
W
h
j
j
j
W
f
f
f
f
l
l
l
f
f
f
f
f
f
f
n
n
n
n
n
n
n
n
"}
(17,1,1) = {"
j
h
j
j
w
f
f
f
f
f
f
f
f
I
j
j
j
j
j
u
j
W
j
j
j
j
j
U
f
f
f
f
f
f
f
n
n
n
n
n
n
n
n
"}
(18,1,1) = {"
j
j
j
j
w
f
f
f
f
f
f
f
f
I
j
j
j
h
j
j
h
j
j
t
j
j
W
f
f
f
f
f
f
f
f
n
n
n
n
n
n
n
n
"}
(19,1,1) = {"
j
h
W
j
U
f
f
f
f
f
f
f
f
I
I
g
g
g
g
g
g
y
g
x
g
g
g
I
I
I
I
I
I
I
I
n
n
n
n
n
n
n
n
"}
(20,1,1) = {"
f
j
j
j
h
w
f
f
f
f
f
f
f
f
f
f
j
j
j
j
h
j
j
w
j
j
j
f
f
f
f
f
f
f
f
n
n
n
n
n
n
n
n
"}
(21,1,1) = {"
f
f
f
j
j
w
f
f
f
f
f
f
f
f
f
f
f
j
j
j
j
j
w
j
j
h
j
f
f
f
f
f
f
f
f
n
n
n
n
n
n
n
n
"}
(22,1,1) = {"
f
f
f
h
j
j
w
j
f
f
f
f
f
f
f
f
f
f
f
f
j
j
w
f
f
j
j
f
f
f
f
f
f
f
f
n
n
n
n
n
n
n
n
"}
(23,1,1) = {"
f
f
f
j
j
j
j
j
j
f
f
f
f
f
f
f
f
f
f
f
f
f
f
f
f
j
j
j
f
f
f
f
f
f
f
n
n
n
n
n
n
n
n
"}
(24,1,1) = {"
f
f
f
j
j
h
j
j
w
j
j
f
f
f
f
f
f
f
f
f
f
f
f
f
j
j
j
j
f
f
f
f
f
f
f
n
n
n
n
n
n
n
n
"}
(25,1,1) = {"
f
f
f
w
j
j
j
h
j
j
p
j
f
f
f
f
f
f
f
f
f
f
f
f
j
J
j
j
f
f
f
f
f
f
f
n
n
n
n
n
n
n
n
"}
(26,1,1) = {"
f
f
f
f
W
j
j
j
j
j
j
h
w
f
f
f
f
f
f
f
f
f
f
f
f
j
W
j
f
f
f
f
f
f
f
n
n
n
n
n
n
n
n
"}
(27,1,1) = {"
f
f
f
j
h
W
j
j
j
j
j
j
j
j
f
f
f
f
f
f
f
f
f
f
f
j
j
h
j
f
f
f
f
f
f
n
n
n
n
n
n
n
n
"}
(28,1,1) = {"
f
f
j
j
j
j
j
j
j
j
j
j
h
j
w
f
f
f
f
f
f
f
f
f
f
f
j
j
j
f
f
f
f
f
f
n
n
n
n
n
n
n
n
"}
(29,1,1) = {"
f
f
j
j
j
j
j
h
j
j
j
j
j
h
j
f
f
f
f
f
f
f
f
f
f
f
j
h
j
f
f
f
f
f
f
n
n
n
n
n
n
n
n
"}
(30,1,1) = {"
f
f
j
h
j
j
j
j
h
w
f
w
W
j
j
j
f
f
f
f
f
f
f
f
f
f
j
h
j
j
f
f
f
f
f
n
n
n
n
n
n
n
n
"}
(31,1,1) = {"
f
j
j
j
j
j
j
j
j
w
f
f
w
W
h
j
j
f
f
f
f
f
f
f
f
f
U
j
j
j
f
f
f
f
f
n
n
n
n
n
n
n
n
"}
(32,1,1) = {"
f
j
W
j
j
W
f
j
j
w
f
f
f
j
W
j
j
W
j
f
f
f
f
f
f
f
w
U
h
j
f
f
f
f
f
n
n
n
n
n
n
n
n
"}
(33,1,1) = {"
f
j
j
j
f
f
f
w
w
f
f
f
f
j
j
j
h
j
h
j
w
f
f
f
f
f
f
w
W
j
j
f
f
f
f
n
n
n
n
n
n
n
n
"}
(34,1,1) = {"
f
j
j
j
f
f
f
f
f
f
f
f
f
f
j
j
j
j
j
j
j
w
f
f
f
f
f
f
j
j
h
j
f
f
f
n
n
n
n
n
n
n
n
"}
(35,1,1) = {"
f
j
j
f
f
f
f
f
f
f
f
f
f
j
h
j
j
j
j
j
w
f
f
f
f
f
f
f
j
j
j
f
f
f
f
n
n
n
n
n
n
n
n
"}
(36,1,1) = {"
f
j
j
f
f
f
f
f
f
f
f
f
f
w
j
j
j
j
h
j
w
f
f
f
f
f
f
f
j
h
j
f
f
f
f
n
n
n
n
n
n
n
n
"}
(37,1,1) = {"
j
j
j
f
f
f
f
f
f
f
f
f
f
f
f
f
j
d
j
j
j
U
f
f
f
f
f
f
j
u
j
f
f
f
f
n
n
n
n
n
n
n
n
"}
(38,1,1) = {"
j
j
j
f
f
f
f
f
f
f
f
f
f
f
f
f
j
j
j
j
j
w
f
f
f
f
w
p
j
h
j
f
f
f
f
n
n
n
n
n
n
n
n
"}
(39,1,1) = {"
j
j
j
f
f
f
f
f
f
f
f
f
f
f
f
f
w
j
j
j
j
w
f
f
f
f
w
w
j
j
f
f
f
f
f
n
n
n
n
n
n
n
n
"}
(40,1,1) = {"
j
h
j
f
f
f
f
f
f
f
f
f
f
f
f
f
f
f
f
h
h
j
w
w
f
f
f
f
j
j
f
f
f
f
f
n
n
n
n
n
n
n
n
"}
(41,1,1) = {"
G
G
G
P
P
P
P
P
P
P
P
P
P
P
f
f
f
f
f
j
j
j
j
w
f
f
f
f
j
h
f
f
f
f
f
n
n
n
n
n
n
n
n
"}
