//MAP CONVERTED BY dmm2tgm.py THIS HEADER COMMENT PREVENTS RECONVERSION, DO NOT REMOVE
"ab" = (
/turf/open/floor/tile/dark/red2/corner{
	dir = 8
	},
/area/bigredv2/caves/south)
"ac" = (
/obj/effect/ai_node,
/turf/open/floor/plating/ground/mars/random/cave,
/area/bigredv2/caves/south)
"ad" = (
/obj/effect/decal/cleanable/dirt,
/turf/open/floor/tile/dark/red2/corner,
/area/bigredv2/caves/south)
"ae" = (
/obj/structure/closet/secure_closet/security,
/turf/open/floor/tile/dark/red2/corner{
	dir = 8
	},
/area/bigredv2/caves/south)
"ag" = (
/obj/effect/landmark/weed_node,
/obj/effect/ai_node,
/turf/open/floor/tile/dark/red2/corner{
	dir = 8
	},
/area/bigredv2/caves/south)
"ah" = (
/turf/closed/mineral/smooth/bigred/indestructible,
/area/space)
"ai" = (
/obj/structure/rack,
/obj/item/storage/holster/belt/revolver,
/obj/item/storage/holster/belt/pistol/m4a3/officer,
/turf/open/floor/tile/dark/red2/corner{
	dir = 8
	},
/area/bigredv2/caves/south)
"aj" = (
/obj/effect/decal/cleanable/dirt,
/turf/closed/wall/r_wall,
/area/bigredv2/caves/south)
"ak" = (
/obj/effect/landmark/weed_node,
/turf/open/floor/tile/dark/yellow2/corner,
/area/bigredv2/caves/south)
"al" = (
/obj/effect/turf_decal/sandedge{
	dir = 8
	},
/turf/open/floor/tile/dark/red2/corner{
	dir = 8
	},
/area/bigredv2/caves/south)
"am" = (
/obj/effect/landmark/weed_node,
/turf/open/floor/tile/dark/red2/corner{
	dir = 8
	},
/area/bigredv2/caves/south)
"an" = (
/obj/effect/landmark/fog_blocker,
/turf/open/floor/tile/dark/yellow2/corner,
/area/bigredv2/caves/south)
"ao" = (
/obj/machinery/door/airlock/multi_tile/mainship/generic{
	dir = 2
	},
/obj/effect/turf_decal/sandedge{
	dir = 8
	},
/turf/open/floor/tile/dark/red2/corner{
	dir = 8
	},
/area/bigredv2/caves/south)
"as" = (
/obj/effect/landmark/fog_blocker,
/turf/closed/wall/r_wall,
/area/bigredv2/caves/south)
"at" = (
/obj/machinery/door/airlock/multi_tile/mainship/generic,
/obj/effect/ai_node,
/turf/open/floor/tile/dark/yellow2/corner,
/area/bigredv2/outside/nanotrasen_lab/inside)
"au" = (
/obj/machinery/light,
/obj/effect/landmark/weed_node,
/turf/open/floor/tile/dark/red2/corner,
/area/bigredv2/caves/south)
"av" = (
/obj/effect/decal/cleanable/dirt,
/turf/closed/wall/r_wall/unmeltable,
/area/bigredv2/caves/south)
"aw" = (
/obj/effect/landmark/corpsespawner/colonist,
/obj/effect/decal/cleanable/blood/oil,
/turf/open/floor/plating/ground/mars/random/cave,
/area/bigredv2/caves/south)
"ax" = (
/obj/effect/decal/cleanable/dirt,
/obj/structure/rack,
/obj/item/storage/holster/belt/pistol/m4a3/full,
/obj/item/storage/holster/belt/pistol/m4a3/officer,
/turf/open/floor/tile/dark/red2/corner,
/area/bigredv2/caves/south)
"ay" = (
/turf/closed/wall/r_wall,
/area/bigredv2/caves/south)
"az" = (
/turf/closed/wall/r_wall/unmeltable,
/area/bigredv2/caves/south)
"aA" = (
/turf/open/floor/plating/ground/mars/random/cave,
/area/bigredv2/caves/south)
"aB" = (
/obj/effect/landmark/corpsespawner/colonist,
/obj/effect/decal/cleanable/blood/oil,
/turf/open/floor/tile/dark/red2/corner,
/area/bigredv2/caves/south)
"aD" = (
/obj/effect/decal/cleanable/dirt,
/obj/effect/turf_decal/sandedge{
	dir = 4
	},
/turf/open/floor/tile/dark/red2/corner{
	dir = 8
	},
/area/bigredv2/caves/south)
"aE" = (
/obj/machinery/light{
	dir = 8
	},
/turf/open/floor/plating/ground/mars/random/cave,
/area/bigredv2/caves/south)
"aF" = (
/turf/open/floor/tile/dark/red2/corner,
/area/bigredv2/caves/south)
"aI" = (
/turf/closed/mineral/smooth/bigred,
/area/bigredv2/caves/rock)
"aJ" = (
/obj/effect/landmark/weed_node,
/turf/open/floor/plating/ground/mars/random/cave,
/area/bigredv2/caves/south)
"aK" = (
/turf/open/floor/tile/dark/yellow2/corner,
/area/bigredv2/caves/south)
"aL" = (
/turf/open/floor/tile/dark/yellow2/corner,
/area/bigredv2/outside/nanotrasen_lab/inside)
"aM" = (
/obj/structure/bed/chair/office/light{
	dir = 1
	},
/turf/open/floor/tile/dark/red2/corner{
	dir = 8
	},
/area/bigredv2/caves/south)
"aO" = (
/obj/effect/landmark/fog_blocker,
/turf/open/floor/plating/ground/mars/random/cave,
/area/bigredv2/caves/south)
"aP" = (
/obj/effect/landmark/fog_blocker,
/turf/closed/wall/r_wall,
/area/bigredv2/outside/nanotrasen_lab/inside)
"aQ" = (
/obj/structure/table,
/obj/item/storage/holster/belt/pistol,
/turf/open/floor/tile/dark/red2/corner,
/area/bigredv2/caves/south)
"aR" = (
/turf/closed/wall/r_wall,
/area/bigredv2/outside/nanotrasen_lab/inside)
"aW" = (
/obj/effect/decal/cleanable/dirt,
/obj/machinery/door/airlock/multi_tile/mainship/generic{
	dir = 2
	},
/obj/effect/turf_decal/sandedge{
	dir = 4
	},
/turf/open/floor/tile/dark/red2/corner{
	dir = 8
	},
/area/bigredv2/caves/south)
"aZ" = (
/obj/structure/table,
/obj/machinery/computer/security,
/turf/open/floor/tile/dark/red2/corner{
	dir = 8
	},
/area/bigredv2/caves/south)
"JO" = (
/obj/effect/landmark/fog_blocker,
/turf/closed/mineral/smooth/bigred,
/area/bigredv2/caves/rock)

(1,1,1) = {"
aR
JO
ay
aj
aD
aW
aj
av
aI
ah
"}
(2,1,1) = {"
aR
JO
ay
aZ
aM
ab
ab
av
aI
ah
"}
(3,1,1) = {"
aR
as
ay
aQ
aF
aB
au
av
aI
ah
"}
(4,1,1) = {"
at
an
aK
ab
ag
ab
ay
av
aI
ah
"}
(5,1,1) = {"
aL
an
ak
ad
ad
ad
ax
av
aI
ah
"}
(6,1,1) = {"
aR
JO
ay
ae
ab
ab
ai
az
aI
ah
"}
(7,1,1) = {"
aR
JO
ay
ae
ab
ab
ay
az
aI
ah
"}
(8,1,1) = {"
aR
JO
ay
ab
am
ab
ab
az
aI
ah
"}
(9,1,1) = {"
aR
JO
ay
ay
al
ao
ay
az
aI
ah
"}
(10,1,1) = {"
aR
JO
aI
aE
aA
aA
aA
aA
aI
ah
"}
(11,1,1) = {"
aR
JO
aI
aA
aA
aA
aA
aw
aI
ah
"}
(12,1,1) = {"
aR
JO
aI
aA
ac
aJ
aJ
aA
aI
ah
"}
(13,1,1) = {"
aR
JO
aI
aI
aA
ac
aA
aA
aI
ah
"}
(14,1,1) = {"
aR
JO
aI
aA
aA
aA
aA
aA
aI
ah
"}
(15,1,1) = {"
aR
aO
aA
aA
aA
aA
aA
aJ
aI
ah
"}
(16,1,1) = {"
aR
aO
aA
aA
aA
aJ
aA
aA
aI
ah
"}
(17,1,1) = {"
aR
aO
aA
aA
aA
aA
aA
aA
aI
ah
"}
(18,1,1) = {"
aR
JO
aI
aA
aA
aA
aA
aA
aI
ah
"}
(19,1,1) = {"
aR
JO
aI
aA
aA
aA
aA
aA
aI
ah
"}
(20,1,1) = {"
aR
JO
aA
aA
aA
aA
aA
aA
aI
ah
"}
(21,1,1) = {"
aR
aO
aA
aA
aA
ac
aA
aI
aI
ah
"}
(22,1,1) = {"
aR
aO
aA
aA
aA
aJ
aA
aI
aI
ah
"}
(23,1,1) = {"
aP
JO
aI
aI
aA
aA
aA
aI
aI
ah
"}
