//MAP CONVERTED BY dmm2tgm.py THIS HEADER COMMENT PREVENTS RECONVERSION, DO NOT REMOVE
"d" = (
/obj/effect/landmark/fog_blocker,
/turf/open/floor/plating/ground/mars/random/cave,
/area/bigredv2/caves/southwest)
"f" = (
/obj/effect/landmark/xeno_silo_spawn,
/turf/open/floor/plating/ground/mars/random/cave,
/area/bigredv2/caves/southwest)
"h" = (
/turf/open/floor/plating/ground/mars/random/cave,
/area/bigredv2/caves/southwest)
"j" = (
/obj/effect/landmark/fog_blocker/xeno_spawn,
/turf/closed/mineral/smooth/bigred,
/area/bigredv2/caves/rock)
"l" = (
/obj/effect/landmark/xeno_resin_wall,
/turf/open/floor/plating/ground/mars/random/cave,
/area/bigredv2/caves/southwest)
"n" = (
/obj/effect/landmark/weed_node,
/obj/effect/landmark/weed_node,
/turf/open/floor/plating/ground/mars/random/cave,
/area/bigredv2/caves/southwest)
"o" = (
/obj/effect/landmark/xeno_resin_door,
/turf/open/floor/plating/ground/mars/random/cave,
/area/bigredv2/caves/southwest)
"q" = (
/obj/effect/landmark/weed_node,
/turf/open/floor/plating/ground/mars/random/cave,
/area/bigredv2/caves/southwest)
"r" = (
/obj/effect/ai_node,
/turf/open/floor/plating/ground/mars/random/cave,
/area/bigredv2/caves/southwest)
"s" = (
/obj/effect/landmark/weed_node,
/obj/effect/landmark/xeno_resin_wall,
/turf/open/floor/plating/ground/mars/random/cave,
/area/bigredv2/caves/southwest)
"t" = (
/turf/closed/mineral/smooth/bigred/indestructible,
/area/space)
"y" = (
/obj/effect/landmark/weed_node,
/obj/effect/ai_node,
/turf/open/floor/plating/ground/mars/random/cave,
/area/bigredv2/caves/southwest)
"B" = (
/obj/effect/landmark/fog_blocker/xeno_spawn,
/turf/open/floor/plating/ground/mars/random/cave,
/area/bigredv2/caves/southwest)
"E" = (
/obj/effect/ai_node,
/turf/open/floor/plating/ground/mars/random/cave/rock,
/area/bigredv2/caves/southwest)
"G" = (
/turf/open/floor/plating/ground/mars/random/cave/rock,
/area/bigredv2/caves/southwest)
"J" = (
/obj/effect/landmark/excavation_site_spawner,
/turf/open/floor/plating/ground/mars/random/cave,
/area/bigredv2/caves/southwest)
"L" = (
/obj/effect/landmark/weed_node,
/turf/open/floor/plating/ground/mars/random/cave/rock,
/area/bigredv2/caves/southwest)
"M" = (
/obj/effect/landmark/fog_blocker,
/turf/closed/mineral/smooth/bigred,
/area/bigredv2/caves/rock)
"N" = (
/obj/effect/landmark/xeno_tunnel_spawn,
/turf/open/floor/plating/ground/mars/random/cave,
/area/bigredv2/caves/southwest)
"P" = (
/turf/closed/mineral/smooth/bigred,
/area/bigredv2/caves/rock)
"W" = (
/obj/effect/landmark/excavation_site_spawner,
/obj/effect/ai_node,
/turf/open/floor/plating/ground/mars/random/cave,
/area/bigredv2/caves/southwest)

(1,1,1) = {"
t
t
t
t
t
t
t
t
t
t
t
t
t
t
t
t
t
t
t
t
t
t
t
t
t
t
t
t
t
t
t
t
t
t
t
t
t
t
t
t
t
t
t
"}
(2,1,1) = {"
P
P
P
P
P
P
P
P
P
P
P
P
j
P
P
P
P
P
P
P
P
P
P
P
P
P
P
P
P
P
P
P
P
P
P
t
t
t
t
t
t
t
t
"}
(3,1,1) = {"
P
P
P
P
P
P
P
P
P
P
P
P
j
P
P
P
P
P
P
P
P
P
P
P
P
P
P
P
P
P
P
P
P
P
P
t
t
t
t
t
t
t
t
"}
(4,1,1) = {"
P
P
P
P
P
P
P
P
P
P
P
P
j
P
P
P
P
P
P
P
P
P
P
P
P
P
P
P
P
P
P
P
P
P
P
t
t
t
t
t
t
t
t
"}
(5,1,1) = {"
P
P
P
P
P
P
P
P
P
P
P
P
j
P
P
P
P
P
P
P
P
P
P
P
P
P
P
P
P
P
P
P
P
P
P
t
t
t
t
t
t
t
t
"}
(6,1,1) = {"
P
P
P
P
P
P
P
P
P
P
P
P
j
P
P
P
P
h
G
G
G
G
G
P
P
P
P
P
P
P
P
P
P
P
P
t
t
t
t
t
t
t
t
"}
(7,1,1) = {"
P
P
P
P
h
h
h
h
h
P
P
P
j
P
P
L
l
h
h
h
h
h
N
G
P
P
P
P
P
P
P
P
P
P
P
t
t
t
t
t
t
t
t
"}
(8,1,1) = {"
P
P
h
h
h
q
h
h
h
h
h
P
j
P
G
h
l
h
h
q
h
q
h
G
P
P
P
P
P
P
P
P
P
P
P
t
t
t
t
t
t
t
t
"}
(9,1,1) = {"
P
h
h
h
h
h
h
h
h
h
h
h
B
h
h
h
l
h
h
h
f
h
h
L
P
P
P
P
P
P
P
P
P
P
P
t
t
t
t
t
t
t
t
"}
(10,1,1) = {"
h
h
r
h
q
q
h
h
q
h
q
r
B
h
h
r
l
h
h
q
r
h
h
h
G
P
P
P
P
P
P
P
P
P
P
t
t
t
t
t
t
t
t
"}
(11,1,1) = {"
q
h
h
h
h
h
q
h
h
h
h
h
B
h
h
h
s
h
h
h
h
h
h
h
G
P
P
P
P
P
P
P
P
P
P
t
t
t
t
t
t
t
t
"}
(12,1,1) = {"
h
h
h
h
h
h
h
h
h
h
P
P
j
h
h
h
l
h
h
h
h
h
h
h
h
h
h
P
P
P
P
P
P
P
P
t
t
t
t
t
t
t
t
"}
(13,1,1) = {"
h
G
E
P
P
P
P
P
P
P
P
P
j
h
h
q
l
l
l
l
o
o
l
l
s
l
l
P
P
P
P
P
P
P
P
t
t
t
t
t
t
t
t
"}
(14,1,1) = {"
h
h
G
P
P
P
P
P
P
P
P
P
j
h
h
h
h
h
h
h
h
h
h
h
h
h
h
G
P
P
P
P
P
P
P
t
t
t
t
t
t
t
t
"}
(15,1,1) = {"
h
h
h
G
G
P
P
P
P
P
P
P
j
G
h
h
h
h
h
q
h
h
h
h
h
h
h
h
P
P
P
P
P
P
P
t
t
t
t
t
t
t
t
"}
(16,1,1) = {"
h
h
n
h
G
P
P
P
P
P
P
P
j
P
h
r
q
h
h
h
r
h
h
h
h
r
h
h
P
P
P
P
P
P
P
t
t
t
t
t
t
t
t
"}
(17,1,1) = {"
h
q
h
h
G
P
P
P
P
P
P
P
j
P
h
h
h
h
h
J
h
h
h
h
h
h
h
G
P
P
P
P
P
P
P
t
t
t
t
t
t
t
t
"}
(18,1,1) = {"
h
h
h
h
G
P
P
P
P
P
P
P
j
P
h
h
h
h
h
h
q
h
h
n
h
h
P
P
P
P
P
P
P
P
P
t
t
t
t
t
t
t
t
"}
(19,1,1) = {"
h
q
r
h
E
P
P
P
P
P
P
P
j
j
B
B
B
B
h
h
h
q
h
G
h
h
P
P
P
P
P
P
P
P
P
t
t
t
t
t
t
t
t
"}
(20,1,1) = {"
P
h
h
h
q
G
P
P
P
P
P
G
G
G
h
h
h
B
h
h
h
h
h
G
h
h
h
P
P
P
P
P
P
P
P
t
t
t
t
t
t
t
t
"}
(21,1,1) = {"
P
P
P
h
h
G
P
P
P
P
P
G
h
h
h
q
h
B
h
h
h
h
G
h
h
q
h
P
P
P
P
P
P
P
P
t
t
t
t
t
t
t
t
"}
(22,1,1) = {"
P
P
P
q
h
h
G
h
P
P
P
h
r
h
h
r
G
j
G
h
h
h
G
P
P
h
h
P
P
P
P
P
P
P
P
t
t
t
t
t
t
t
t
"}
(23,1,1) = {"
P
P
P
h
h
h
h
h
h
P
h
h
h
h
h
G
P
j
j
j
j
j
j
j
j
B
B
B
j
j
j
j
j
j
j
t
t
t
t
t
t
t
t
"}
(24,1,1) = {"
P
P
P
h
h
q
h
h
G
h
h
G
h
q
h
G
P
P
P
P
P
P
P
P
h
h
h
h
P
P
P
P
P
P
P
t
t
t
t
t
t
t
t
"}
(25,1,1) = {"
P
P
P
G
h
h
h
q
h
h
L
h
h
h
h
P
P
P
P
P
P
P
P
P
h
y
h
h
P
P
P
P
P
P
P
t
t
t
t
t
t
t
t
"}
(26,1,1) = {"
P
P
P
P
r
h
h
h
h
h
h
q
G
h
h
P
P
P
P
P
P
P
P
P
P
h
r
h
P
P
P
P
P
P
P
t
t
t
t
t
t
t
t
"}
(27,1,1) = {"
P
P
P
h
q
r
h
h
h
h
h
h
r
h
h
P
P
P
P
P
P
P
P
P
P
h
h
q
h
P
P
P
P
P
P
t
t
t
t
t
t
t
t
"}
(28,1,1) = {"
P
P
h
h
h
h
h
h
h
h
h
h
q
h
G
P
P
P
P
P
P
P
P
P
P
P
h
h
h
P
P
P
P
P
P
t
t
t
t
t
t
t
t
"}
(29,1,1) = {"
P
P
h
h
h
h
h
q
h
h
h
h
h
q
h
P
P
P
P
P
P
P
P
P
P
P
h
q
h
P
P
P
P
P
P
t
t
t
t
t
t
t
t
"}
(30,1,1) = {"
P
P
h
q
h
h
h
h
q
G
P
G
r
h
h
h
P
P
P
P
P
P
P
P
P
P
h
q
h
h
P
P
P
P
P
t
t
t
t
t
t
t
t
"}
(31,1,1) = {"
P
h
h
h
h
h
h
h
h
G
P
P
G
r
q
h
h
P
P
P
P
P
P
P
P
P
E
h
h
h
P
P
P
P
P
t
t
t
t
t
t
t
t
"}
(32,1,1) = {"
P
h
r
h
h
r
P
h
h
G
P
P
P
h
r
h
h
r
h
P
P
P
P
P
P
P
G
E
q
h
P
P
P
P
P
t
t
t
t
t
t
t
t
"}
(33,1,1) = {"
P
h
h
h
P
P
P
G
G
P
P
P
P
h
h
h
q
h
q
h
G
P
P
P
P
P
P
G
r
h
h
P
P
P
P
t
t
t
t
t
t
t
t
"}
(34,1,1) = {"
P
h
h
h
P
P
P
P
P
P
P
P
P
P
h
h
h
h
h
h
h
G
P
P
P
P
P
P
h
h
h
h
P
P
P
t
t
t
t
t
t
t
t
"}
(35,1,1) = {"
P
h
h
P
P
P
P
P
P
P
P
P
P
h
h
h
h
h
h
h
G
P
P
P
P
P
P
P
h
h
h
P
P
P
P
t
t
t
t
t
t
t
t
"}
(36,1,1) = {"
P
h
h
P
P
P
P
P
P
P
P
P
P
G
h
h
h
h
q
h
G
P
P
P
P
P
P
P
h
q
h
P
P
P
P
t
t
t
t
t
t
t
t
"}
(37,1,1) = {"
h
h
h
P
P
P
P
P
P
P
P
P
P
P
P
P
h
W
h
h
h
E
P
P
P
P
P
P
h
J
h
P
P
P
P
t
t
t
t
t
t
t
t
"}
(38,1,1) = {"
h
h
h
P
P
P
P
P
P
P
P
P
P
P
P
P
h
h
h
h
h
G
P
P
P
P
G
L
h
q
h
P
P
P
P
t
t
t
t
t
t
t
t
"}
(39,1,1) = {"
h
h
h
P
P
P
P
P
P
P
P
P
P
P
P
P
G
h
h
h
h
G
P
P
P
P
G
G
h
h
P
P
P
P
P
t
t
t
t
t
t
t
t
"}
(40,1,1) = {"
h
q
h
P
P
P
P
P
P
P
P
P
P
P
P
P
P
P
P
q
q
h
G
G
P
P
P
P
h
h
P
P
P
P
P
t
t
t
t
t
t
t
t
"}
(41,1,1) = {"
d
d
d
M
M
M
M
M
M
M
M
M
M
M
P
P
P
P
P
h
h
h
h
G
P
P
P
P
h
q
P
P
P
P
P
t
t
t
t
t
t
t
t
"}
