//MAP CONVERTED BY dmm2tgm.py THIS HEADER COMMENT PREVENTS RECONVERSION, DO NOT REMOVE
"b" = (
/turf/open/floor/plating/ground/mars/random/cave/rock,
/area/bigredv2/caves/southwest)
"c" = (
/obj/effect/landmark/fog_blocker/xeno_spawn,
/turf/open/floor/plating/ground/mars/random/cave,
/area/bigredv2/caves/southwest)
"d" = (
/obj/effect/ai_node,
/turf/open/floor/plating/ground/mars/random/cave/rock,
/area/bigredv2/caves/southwest)
"g" = (
/obj/effect/landmark/weed_node,
/turf/open/floor/plating/ground/mars/random/cave,
/area/bigredv2/caves/southwest)
"h" = (
/obj/effect/landmark/excavation_site_spawner,
/obj/effect/ai_node,
/turf/open/floor/plating/ground/mars/random/cave,
/area/bigredv2/caves/southwest)
"j" = (
/turf/closed/mineral/smooth/bigred,
/area/bigredv2/caves/rock)
"k" = (
/obj/effect/landmark/excavation_site_spawner,
/turf/open/floor/plating/ground/mars/random/cave,
/area/bigredv2/caves/southwest)
"l" = (
/turf/closed/mineral/smooth/bigred/indestructible,
/area/space)
"m" = (
/obj/effect/landmark/weed_node,
/obj/effect/landmark/weed_node,
/turf/open/floor/plating/ground/mars/random/cave,
/area/bigredv2/caves/southwest)
"q" = (
/obj/effect/landmark/xeno_resin_wall,
/turf/open/floor/plating/ground/mars/random/cave,
/area/bigredv2/caves/southwest)
"t" = (
/obj/effect/landmark/fog_blocker/xeno_spawn,
/turf/closed/mineral/smooth/bigred,
/area/bigredv2/caves/rock)
"u" = (
/obj/effect/landmark/fog_blocker/xeno_spawn,
/turf/open/floor/plating/ground/mars/random/cave/rock,
/area/bigredv2/caves/southwest)
"v" = (
/obj/effect/landmark/xeno_tunnel_spawn,
/turf/open/floor/plating/ground/mars/random/cave,
/area/bigredv2/caves/southwest)
"w" = (
/obj/effect/landmark/xeno_resin_door,
/turf/open/floor/plating/ground/mars/random/cave,
/area/bigredv2/caves/southwest)
"x" = (
/obj/effect/landmark/weed_node,
/obj/effect/landmark/xeno_resin_wall,
/turf/open/floor/plating/ground/mars/random/cave,
/area/bigredv2/caves/southwest)
"z" = (
/obj/effect/landmark/fog_blocker,
/turf/open/floor/plating/ground/mars/random/cave,
/area/bigredv2/caves/southwest)
"F" = (
/obj/effect/landmark/weed_node,
/obj/effect/ai_node,
/turf/open/floor/plating/ground/mars/random/cave,
/area/bigredv2/caves/southwest)
"J" = (
/obj/effect/landmark/xeno_resin_wall,
/turf/open/floor/plating/ground/mars/random/cave/rock,
/area/bigredv2/caves/southwest)
"M" = (
/obj/effect/ai_node,
/turf/open/floor/plating/ground/mars/random/cave,
/area/bigredv2/caves/southwest)
"N" = (
/turf/open/floor/plating/ground/mars/random/cave,
/area/bigredv2/caves/southwest)
"O" = (
/obj/effect/landmark/fog_blocker,
/turf/closed/mineral/smooth/bigred,
/area/bigredv2/caves/rock)
"Q" = (
/obj/effect/landmark/weed_node,
/turf/open/floor/plating/ground/mars/random/cave/rock,
/area/bigredv2/caves/southwest)
"Y" = (
/obj/effect/landmark/xeno_silo_spawn,
/turf/open/floor/plating/ground/mars/random/cave,
/area/bigredv2/caves/southwest)

(1,1,1) = {"
l
l
l
l
l
l
l
l
l
l
l
l
l
l
l
l
l
l
l
l
l
l
l
l
l
l
l
l
l
l
l
l
l
l
l
l
l
l
l
l
l
l
l
"}
(2,1,1) = {"
j
j
j
j
j
j
j
j
j
j
j
j
j
j
j
j
j
j
j
j
j
j
j
j
j
j
j
j
j
j
j
j
j
j
j
l
l
l
l
l
l
l
l
"}
(3,1,1) = {"
j
j
j
j
j
j
j
j
j
j
j
j
j
j
j
j
j
j
j
j
j
j
j
j
j
j
j
j
j
j
j
j
j
j
j
l
l
l
l
l
l
l
l
"}
(4,1,1) = {"
j
j
j
j
j
j
j
j
j
j
j
j
j
j
j
j
j
j
j
j
j
j
j
j
j
j
j
j
j
j
j
j
j
j
j
l
l
l
l
l
l
l
l
"}
(5,1,1) = {"
j
j
j
j
j
j
j
j
j
j
j
j
j
j
j
j
j
j
j
j
j
j
j
j
j
j
j
j
j
j
j
j
j
j
j
l
l
l
l
l
l
l
l
"}
(6,1,1) = {"
j
j
j
j
j
j
j
j
j
j
j
j
j
j
j
j
j
j
j
j
j
j
j
j
j
j
j
j
j
j
j
j
j
j
j
l
l
l
l
l
l
l
l
"}
(7,1,1) = {"
j
j
j
j
j
j
j
j
j
j
j
j
j
j
j
j
j
j
j
j
j
j
j
j
j
j
j
j
j
j
j
j
j
j
j
l
l
l
l
l
l
l
l
"}
(8,1,1) = {"
j
j
j
j
j
j
j
j
j
j
j
j
j
j
j
j
j
j
j
j
j
j
j
j
j
j
j
j
j
j
j
j
j
j
j
l
l
l
l
l
l
l
l
"}
(9,1,1) = {"
j
j
j
j
j
j
j
j
j
j
j
j
j
j
j
j
j
j
j
j
j
N
N
j
j
j
j
j
j
j
j
j
j
j
j
l
l
l
l
l
l
l
l
"}
(10,1,1) = {"
N
N
j
j
j
j
j
j
j
j
j
j
j
j
j
j
j
N
N
g
N
N
N
j
j
j
j
j
j
j
j
j
j
j
j
l
l
l
l
l
l
l
l
"}
(11,1,1) = {"
g
N
N
j
j
j
j
j
j
j
j
j
j
j
j
j
N
N
N
N
N
N
N
N
j
j
j
j
j
j
j
j
j
j
j
l
l
l
l
l
l
l
l
"}
(12,1,1) = {"
N
N
N
b
b
j
j
j
j
j
j
j
j
j
j
j
N
N
j
j
N
N
N
N
j
j
j
j
j
j
j
j
j
j
j
l
l
l
l
l
l
l
l
"}
(13,1,1) = {"
N
b
d
N
b
j
j
j
j
j
j
j
j
j
j
g
N
N
j
j
j
j
N
N
g
j
j
j
j
j
j
j
j
j
j
l
l
l
l
l
l
l
l
"}
(14,1,1) = {"
N
N
b
N
b
j
j
j
j
j
j
j
j
j
j
N
N
N
N
j
j
j
N
N
N
j
j
j
j
j
j
j
j
j
j
l
l
l
l
l
l
l
l
"}
(15,1,1) = {"
N
N
N
N
b
j
j
j
j
j
j
j
j
j
j
N
N
N
N
g
j
j
j
N
N
j
j
j
j
j
j
j
j
j
j
l
l
l
l
l
l
l
l
"}
(16,1,1) = {"
N
N
m
N
d
j
j
j
j
j
j
j
j
j
j
N
g
N
N
N
N
j
j
N
N
j
j
j
j
j
j
j
j
j
j
l
l
l
l
l
l
l
l
"}
(17,1,1) = {"
N
g
N
N
g
d
j
j
j
j
j
b
b
b
N
N
N
N
N
k
N
N
N
N
N
j
j
j
j
j
j
j
j
j
j
l
l
l
l
l
l
l
l
"}
(18,1,1) = {"
N
N
N
N
N
b
j
j
j
j
j
b
N
N
N
N
N
N
N
N
g
N
N
m
N
j
j
j
j
j
j
j
j
j
j
l
l
l
l
l
l
l
l
"}
(19,1,1) = {"
N
g
M
g
N
N
b
N
j
j
j
N
M
N
N
N
N
N
N
N
N
g
N
b
N
N
j
j
j
j
j
j
j
j
j
l
l
l
l
l
l
l
l
"}
(20,1,1) = {"
j
N
N
N
N
N
N
N
N
j
N
N
N
N
N
N
N
N
N
N
N
N
N
b
N
N
N
j
j
j
j
j
j
j
j
l
l
l
l
l
l
l
l
"}
(21,1,1) = {"
j
j
j
N
N
N
N
N
N
N
N
N
N
N
N
g
N
N
N
N
N
N
b
N
N
g
N
j
j
j
j
j
j
j
j
l
l
l
l
l
l
l
l
"}
(22,1,1) = {"
j
j
j
N
N
M
N
N
N
N
N
N
M
N
N
M
b
j
b
N
N
N
b
j
j
N
N
j
j
j
j
j
j
j
j
l
l
l
l
l
l
l
l
"}
(23,1,1) = {"
j
j
j
N
N
N
N
N
N
N
N
N
N
N
N
b
j
j
j
j
j
j
j
j
j
N
N
N
j
j
j
j
j
j
j
l
l
l
l
l
l
l
l
"}
(24,1,1) = {"
j
j
j
N
N
g
N
N
b
N
N
b
N
g
N
b
j
j
j
j
j
j
j
j
N
N
N
N
j
j
j
j
j
j
j
l
l
l
l
l
l
l
l
"}
(25,1,1) = {"
j
j
j
b
N
N
N
g
N
N
Q
N
N
N
N
j
j
j
j
j
j
j
j
j
N
F
N
N
j
j
j
j
j
j
j
l
l
l
l
l
l
l
l
"}
(26,1,1) = {"
j
j
j
j
M
N
N
N
N
N
N
g
b
N
N
t
t
t
t
t
t
t
t
t
t
N
M
N
j
j
j
j
j
j
j
l
l
l
l
l
l
l
l
"}
(27,1,1) = {"
j
j
j
N
g
M
N
N
N
N
N
N
M
N
N
t
j
j
j
j
j
j
j
j
t
N
N
g
N
j
j
j
j
j
j
l
l
l
l
l
l
l
l
"}
(28,1,1) = {"
j
j
N
N
N
N
N
N
N
N
N
N
g
N
b
t
j
j
j
N
g
v
j
j
t
j
N
N
N
j
j
j
j
j
j
l
l
l
l
l
l
l
l
"}
(29,1,1) = {"
j
j
N
N
N
N
N
g
N
N
N
N
N
g
N
t
j
j
N
N
N
Y
N
j
t
j
N
g
N
j
j
j
j
j
j
l
l
l
l
l
l
l
l
"}
(30,1,1) = {"
j
j
N
g
N
N
N
N
g
b
j
b
M
N
F
c
j
j
N
g
N
N
g
j
t
j
N
g
N
N
j
j
j
j
j
l
l
l
l
l
l
l
l
"}
(31,1,1) = {"
j
N
N
N
N
N
N
N
N
b
j
j
b
M
g
c
q
j
M
N
N
N
N
j
t
j
d
N
N
N
j
j
j
j
j
l
l
l
l
l
l
l
l
"}
(32,1,1) = {"
j
N
M
N
N
M
j
N
N
b
j
j
j
N
N
c
q
M
N
N
N
N
j
j
t
j
b
d
g
N
j
j
j
j
j
l
l
l
l
l
l
l
l
"}
(33,1,1) = {"
j
N
N
N
j
j
j
b
b
j
j
j
j
N
N
c
x
N
g
N
b
g
j
j
t
j
j
b
M
N
N
j
j
j
j
l
l
l
l
l
l
l
l
"}
(34,1,1) = {"
j
N
N
N
j
j
j
j
j
j
j
j
j
j
N
c
q
w
w
w
q
J
j
j
t
j
j
j
N
N
N
N
j
j
j
l
l
l
l
l
l
l
l
"}
(35,1,1) = {"
j
N
N
j
j
j
j
j
j
j
j
j
j
N
N
c
c
c
c
c
u
t
t
t
t
j
j
j
N
N
N
j
j
j
j
l
l
l
l
l
l
l
l
"}
(36,1,1) = {"
j
N
N
j
j
j
j
j
j
j
j
j
j
b
F
N
N
g
F
N
b
j
j
j
j
j
j
j
N
g
N
j
j
j
j
l
l
l
l
l
l
l
l
"}
(37,1,1) = {"
N
N
N
j
j
j
j
j
j
j
j
j
j
j
j
j
N
h
N
M
N
d
j
j
j
j
j
j
N
k
N
j
j
j
j
l
l
l
l
l
l
l
l
"}
(38,1,1) = {"
N
N
N
j
j
j
j
j
j
j
j
j
j
j
j
j
N
N
N
N
N
b
j
j
j
j
b
Q
N
g
N
j
j
j
j
l
l
l
l
l
l
l
l
"}
(39,1,1) = {"
N
N
N
j
j
j
j
j
j
j
j
j
j
j
j
j
b
N
N
N
N
b
j
j
j
j
b
b
N
N
j
j
j
j
j
l
l
l
l
l
l
l
l
"}
(40,1,1) = {"
N
g
N
j
j
j
j
j
j
j
j
j
j
j
j
j
j
j
j
g
g
N
b
b
j
j
j
j
N
N
j
j
j
j
j
l
l
l
l
l
l
l
l
"}
(41,1,1) = {"
z
z
z
O
O
O
O
O
O
O
O
O
O
O
j
j
j
j
j
N
N
N
N
b
j
j
j
j
N
g
j
j
j
j
j
l
l
l
l
l
l
l
l
"}
