//MAP CONVERTED BY dmm2tgm.py THIS HEADER COMMENT PREVENTS RECONVERSION, DO NOT REMOVE
"aa" = (
/turf/open/floor/plating/ground/dirt,
/area/lv624/ground/caves/central3)
"ab" = (
/obj/structure/rack,
/obj/item/stack/sheet/mineral/diamond{
	amount = 2
	},
/turf/open/floor/tile/vault{
	dir = 8
	},
/area/lv624/ground/caves/central1)
"ac" = (
/obj/effect/landmark/xeno_resin_wall,
/turf/open/floor/plating/ground/dirt,
/area/lv624/ground/caves/central2)
"ad" = (
/obj/effect/landmark/weed_node,
/turf/open/floor/plating/ground/dirt,
/area/lv624/ground/caves/central2)
"ae" = (
/obj/effect/landmark/fog_blocker/xeno_spawn,
/turf/open/floor/plating/ground/dirt,
/area/lv624/ground/caves/central2)
"af" = (
/turf/open/floor/plating/ground/dirt,
/area/lv624/ground/caves/central2)
"ag" = (
/obj/structure/rack,
/turf/open/floor/tile/vault{
	dir = 8
	},
/area/lv624/ground/caves/central1)
"aj" = (
/obj/machinery/door/airlock/mainship/secure/locked/free_access{
	dir = 4;
	name = "\improper Mining Storage"
	},
/turf/open/floor/tile/dark,
/area/lv624/ground/caves/central1)
"ak" = (
/obj/structure/rack,
/obj/item/stack/sheet/metal{
	amount = 50;
	pixel_x = 4;
	pixel_y = 4
	},
/obj/item/stack/sheet/metal{
	amount = 30
	},
/turf/open/floor/tile/vault{
	dir = 8
	},
/area/lv624/ground/caves/central1)
"am" = (
/obj/effect/landmark/xeno_resin_door,
/turf/open/floor/plating/ground/dirt,
/area/lv624/ground/caves/central3)
"an" = (
/turf/closed/wall,
/area/lv624/ground/caves/central1)
"ao" = (
/obj/structure/rack,
/obj/item/stack/sheet/mineral/iron{
	amount = 5
	},
/obj/item/stack/sheet/mineral/platinum,
/obj/machinery/light{
	dir = 8
	},
/obj/effect/landmark/fog_blocker/xeno_spawn,
/turf/open/floor/tile/vault{
	dir = 8
	},
/area/lv624/ground/caves/central1)
"aq" = (
/turf/closed/wall/r_wall,
/area/lv624/ground/caves/rock)
"ar" = (
/turf/open/floor/plating/ground/dirt,
/area/lv624/ground/caves/central1)
"as" = (
/turf/closed/wall/r_wall,
/area/lv624/ground/caves/central1)
"av" = (
/obj/structure/rack,
/obj/effect/spawner/random/engineering/pickaxe,
/turf/open/floor/tile/vault{
	dir = 8
	},
/area/lv624/ground/caves/central1)
"ax" = (
/obj/structure/rack,
/obj/item/stack/sheet/mineral/gold{
	amount = 2
	},
/obj/item/stack/sheet/mineral/platinum{
	pixel_x = -6
	},
/turf/open/floor/tile/vault{
	dir = 8
	},
/area/lv624/ground/caves/central1)
"ay" = (
/obj/effect/landmark/fog_blocker/xeno_spawn,
/obj/effect/landmark/xeno_resin_wall,
/turf/open/floor/plating/ground/dirt,
/area/lv624/ground/caves/central2)
"az" = (
/obj/structure/rack,
/obj/item/stack/sheet/mineral/silver{
	amount = 20
	},
/turf/open/floor/tile/vault{
	dir = 8
	},
/area/lv624/ground/caves/central1)
"aB" = (
/obj/effect/landmark/weed_node,
/obj/effect/landmark/xeno_silo_spawn,
/turf/open/floor/plating/ground/dirt,
/area/lv624/ground/caves/central2)
"aC" = (
/turf/closed/mineral/smooth,
/area/lv624/ground/caves/rock)
"aD" = (
/obj/effect/landmark/weed_node,
/turf/open/floor/tile/dark,
/area/lv624/ground/caves/central1)
"aG" = (
/obj/structure/flora/ausbushes/fullgrass,
/turf/open/floor/plating/ground/dirt,
/area/lv624/ground/caves/central2)
"aH" = (
/obj/effect/landmark/miner_platinum,
/turf/open/floor/plating/ground/dirt,
/area/lv624/ground/caves/central2)
"aI" = (
/turf/open/floor,
/area/lv624/ground/caves/central1)
"aJ" = (
/obj/effect/ai_node,
/turf/open/floor/plating/ground/dirt,
/area/lv624/ground/caves/central1)
"aK" = (
/obj/effect/landmark/weed_node,
/turf/open/floor,
/area/lv624/ground/caves/central1)
"aL" = (
/obj/effect/landmark/fog_blocker/xeno_spawn,
/turf/closed/wall/r_wall,
/area/lv624/ground/caves/rock)
"aM" = (
/turf/closed/mineral/smooth/indestructible,
/area/lv624/ground/caves/rock)
"aO" = (
/obj/effect/landmark/fog_blocker/xeno_spawn,
/obj/effect/landmark/weed_node,
/turf/open/floor/plating/ground/dirt,
/area/lv624/ground/caves/central2)
"aP" = (
/obj/structure/rack,
/obj/item/tool/shovel,
/turf/open/floor/tile/vault{
	dir = 8
	},
/area/lv624/ground/caves/central1)
"aR" = (
/obj/structure/rack,
/obj/item/stack/sheet/mineral/tritium{
	pixel_x = -4
	},
/turf/open/floor/tile/vault{
	dir = 8
	},
/area/lv624/ground/caves/central1)
"aS" = (
/obj/effect/landmark/xeno_resin_wall,
/turf/open/floor/plating/ground/dirt,
/area/lv624/ground/caves/central1)
"aT" = (
/obj/effect/landmark/excavation_site_spawner,
/turf/open/floor/plating/ground/dirt,
/area/lv624/ground/caves/central2)
"aU" = (
/obj/effect/landmark/fog_blocker/xeno_spawn,
/turf/closed/mineral/smooth,
/area/lv624/ground/caves/rock)
"aV" = (
/turf/open/floor/tile/dark,
/area/lv624/ground/caves/central1)
"aW" = (
/obj/effect/landmark/weed_node,
/turf/open/floor/plating/ground/dirt,
/area/lv624/ground/caves/central1)
"aX" = (
/obj/structure/rack,
/obj/item/tool/shovel,
/obj/effect/landmark/fog_blocker/xeno_spawn,
/turf/open/floor/tile/vault{
	dir = 8
	},
/area/lv624/ground/caves/central1)
"aY" = (
/obj/effect/landmark/weed_node,
/turf/open/floor/plating/ground/dirt,
/area/lv624/ground/caves/central3)
"aZ" = (
/obj/effect/landmark/xeno_resin_door,
/turf/open/floor/plating/ground/dirt,
/area/lv624/ground/caves/central2)
"bq" = (
/obj/effect/landmark/fog_blocker,
/turf/closed/mineral/smooth,
/area/lv624/ground/caves/rock)
"dl" = (
/obj/effect/landmark/fog_blocker,
/obj/effect/landmark/fog_blocker/xeno_spawn,
/turf/closed/mineral/smooth,
/area/lv624/ground/caves/rock)
"dJ" = (
/obj/effect/landmark/weed_node,
/obj/effect/ai_node,
/turf/open/floor/plating/ground/dirt,
/area/lv624/ground/caves/central2)
"eP" = (
/obj/effect/landmark/weed_node,
/obj/effect/ai_node,
/turf/open/floor/plating/ground/dirt,
/area/lv624/ground/caves/central1)
"tq" = (
/turf/closed/mineral/smooth,
/area/lv624/ground/caves/central2)
"NV" = (
/obj/effect/ai_node,
/turf/open/floor/plating/ground/dirt,
/area/lv624/ground/caves/central2)
"Pf" = (
/obj/structure/rack,
/obj/effect/landmark/fog_blocker/xeno_spawn,
/turf/open/floor/tile/vault{
	dir = 8
	},
/area/lv624/ground/caves/central1)
"VY" = (
/obj/effect/landmark/excavation_site_spawner,
/turf/open/floor/plating/ground/dirt,
/area/lv624/ground/caves/central1)
"ZQ" = (
/obj/effect/landmark/xeno_resin_door,
/turf/open/floor/plating/ground/dirt,
/area/lv624/ground/caves/central1)

(1,1,1) = {"
aC
aC
aC
aC
aC
aC
aC
aC
aC
aC
am
am
am
am
am
aC
aC
aC
aC
aC
aC
aC
aC
aC
aC
aC
aC
aa
aa
aa
aY
aa
aa
"}
(2,1,1) = {"
aC
aC
aC
aC
aC
aC
aC
aC
aC
aC
af
NV
af
af
NV
aC
aC
aC
aC
aC
aC
aC
aC
aC
aC
aC
aC
aC
aC
aC
aC
aC
aa
"}
(3,1,1) = {"
aC
aC
aC
aC
aC
aC
aC
aC
aC
aC
NV
af
ad
af
ad
af
aC
aC
aC
aC
aC
aC
aC
aC
aC
aC
aC
aC
aC
aC
aC
aC
aC
"}
(4,1,1) = {"
aC
aC
aC
aC
aC
aC
aC
af
af
af
af
ac
ac
af
af
ad
ac
aC
aC
aC
aC
aC
aC
aC
aC
aC
aC
aC
aC
aC
aC
aC
aC
"}
(5,1,1) = {"
aC
aC
aC
aC
aC
aC
aC
ad
ac
ac
NV
af
af
af
NV
af
ac
aC
aC
aC
aC
aC
aC
aC
aC
aC
aC
aC
aC
aC
aC
aC
aC
"}
(6,1,1) = {"
aC
aC
aC
aC
aC
aC
af
af
ac
ac
af
ad
af
ac
af
af
ac
aC
aC
aC
aC
aC
aC
aC
aC
aC
aC
aC
aC
aC
aC
aC
aC
"}
(7,1,1) = {"
aC
aC
aC
aC
aC
aC
ad
af
af
af
af
aG
af
af
af
ad
aC
aC
aC
aC
aC
aC
aC
aC
aC
aC
aC
aC
aC
aC
aC
aC
aC
"}
(8,1,1) = {"
aC
aC
aC
aC
aC
af
af
ac
af
af
aH
af
af
ad
af
aC
aC
aC
aC
aC
aC
aC
aC
aC
aC
aC
aC
aC
aC
aC
aC
aC
aC
"}
(9,1,1) = {"
aC
aC
aC
aC
aC
af
ac
ac
ac
af
af
af
ac
ac
af
aC
aC
aC
aC
aC
aC
aC
aC
aC
aC
aC
aC
aC
aC
aC
aC
aC
aC
"}
(10,1,1) = {"
aC
aC
aC
aC
aC
af
af
ac
af
aT
af
ad
ac
ac
af
aC
aC
aC
aC
aC
aC
aC
aC
aC
aC
aC
aC
aC
aC
aC
aC
aC
aC
"}
(11,1,1) = {"
aC
aC
aC
aC
aC
af
NV
af
af
af
NV
af
af
af
NV
af
aC
aC
aC
aC
aC
aC
aC
aC
aC
aC
aC
aC
aC
aC
aC
aC
aC
"}
(12,1,1) = {"
aC
aC
aC
aC
aC
af
ad
af
ad
af
aC
aC
af
af
ad
af
aC
aC
aC
aC
aC
aC
aC
aC
aC
aC
aC
aC
aC
aC
aC
aC
aC
"}
(13,1,1) = {"
aC
aC
aC
aC
aC
af
af
af
af
aC
aC
aC
aC
af
af
af
aC
aC
aC
aC
aC
aC
aC
aC
aC
aC
aC
aC
aC
aC
aC
aC
aC
"}
(14,1,1) = {"
aC
aC
aC
aC
ac
aZ
aZ
aZ
aC
aC
aC
aC
aC
aZ
aZ
aZ
aC
aC
aC
aC
aC
aC
aC
aC
aC
aC
aC
aC
aC
aC
aC
aC
aC
"}
(15,1,1) = {"
aC
aC
aC
ac
ac
af
ad
aC
aC
aC
aC
aC
aC
af
af
af
aC
aC
aC
aC
aC
aC
aC
aC
aC
aC
aC
aC
aC
aC
aC
aC
aC
"}
(16,1,1) = {"
aC
aC
aC
ac
af
af
NV
aC
aC
aC
aC
aC
af
af
ad
af
aC
aC
aC
aC
aC
aC
aC
aC
aC
aC
aC
aC
aC
aC
aC
aC
aC
"}
(17,1,1) = {"
aC
aC
aC
ac
af
NV
aC
aC
aC
aC
NV
af
af
af
NV
af
aC
aC
aC
aC
aC
aC
aC
aC
aC
aC
aC
aC
aC
aC
aC
aC
aC
"}
(18,1,1) = {"
aC
aC
aC
ac
af
af
aC
aC
aC
af
af
ac
ad
af
af
aC
aC
aC
aC
aC
aC
aC
aC
aC
aC
aC
aC
aC
aC
aC
aC
aM
aM
"}
(19,1,1) = {"
aC
aC
aC
ac
af
dJ
af
NV
af
af
NV
ac
af
af
aC
aC
aC
aC
aC
aC
aC
aC
aC
aC
aC
aC
aC
aC
aC
aC
aC
aM
aM
"}
(20,1,1) = {"
aC
aC
ac
ac
af
af
af
ad
af
af
ad
af
af
aC
aC
aC
aC
aC
aC
aC
aC
aC
aC
aC
aC
aC
aC
aC
aC
aC
aC
aM
aM
"}
(21,1,1) = {"
aC
aC
ac
af
af
aH
af
af
ac
ac
af
af
aC
aC
aC
aC
aC
aC
aC
aC
aC
aC
aC
aC
aC
aC
aC
aC
aC
aC
aC
aC
aC
"}
(22,1,1) = {"
aC
tq
ac
ad
af
ad
af
af
ac
ac
af
af
aC
aC
aC
aC
aC
aC
aC
aC
aC
aC
aC
aC
aC
aC
aC
aC
aC
aC
aC
aC
aC
"}
(23,1,1) = {"
aC
ac
ac
af
af
af
ac
NV
af
af
NV
aC
aC
aC
aC
aC
aC
aC
aC
aC
aC
aC
aC
aC
aC
aC
aC
aC
aC
aC
aC
aC
aC
"}
(24,1,1) = {"
aC
ac
af
af
af
af
ac
af
ad
af
aC
aC
aC
aC
aC
aC
aC
aC
aC
aC
aC
aC
aC
aC
aC
aC
aC
aC
aC
aC
aC
aC
aC
"}
(25,1,1) = {"
aC
ac
af
ad
ac
af
ac
af
af
af
aC
aC
aC
aC
aC
aC
aC
aC
aC
aC
aC
aC
aC
aC
aC
aC
aC
aC
aC
aC
aC
aC
aC
"}
(26,1,1) = {"
aC
ac
NV
aG
af
NV
af
NV
af
aC
aC
aC
aC
aC
aC
aC
aC
aC
aC
aC
aC
aC
aC
aC
aC
aC
aC
aC
aC
aC
aC
aC
aC
"}
(27,1,1) = {"
aC
ac
af
aG
ad
af
af
ad
af
aC
aC
aC
aC
aC
aC
aC
aC
aC
aC
aC
aC
aC
aC
aC
aC
aC
aC
aC
aC
aC
aC
aC
aC
"}
(28,1,1) = {"
aC
ac
af
af
ac
ac
af
af
ac
aC
aC
aC
aC
aC
aC
aC
aC
aC
aC
aC
aC
aC
aC
aC
aC
aC
aC
aC
aC
aC
aC
aC
aC
"}
(29,1,1) = {"
aC
ac
af
af
ac
ac
af
ad
ac
aC
aC
aC
aC
aC
aC
aC
aC
aC
aC
aC
aC
aC
aC
aC
aC
aC
aC
aC
aC
aC
aC
aC
aC
"}
(30,1,1) = {"
aC
ac
ad
af
ad
af
af
af
ac
aC
aC
aC
aC
aC
aC
aC
aC
aC
aC
aC
aC
aC
aC
aC
aC
aC
aC
aC
aC
aC
aC
aC
aC
"}
(31,1,1) = {"
aC
ac
af
af
aT
af
ad
af
af
aC
aC
aC
aC
aC
aC
aC
aC
aC
aC
aC
aC
aC
aC
aC
aC
aC
aC
aC
aC
aC
aC
aC
aC
"}
(32,1,1) = {"
aC
ac
af
ac
af
ac
ac
af
NV
aC
aC
aC
aC
aC
aC
aC
aC
aC
aC
aC
aC
aC
aC
aC
aC
aC
aC
aC
aC
aC
aC
aC
aC
"}
(33,1,1) = {"
aC
ac
af
ac
af
af
af
NV
ad
aC
aC
aC
aC
aC
aC
aC
aC
aC
aC
aC
aC
aC
aC
aC
aC
aC
aC
aC
aC
aC
aC
aC
aC
"}
(34,1,1) = {"
aC
ac
dJ
af
af
ad
NV
ac
af
aC
aC
aC
aC
aC
aC
aC
aC
aC
aC
aC
aC
aC
aC
aC
aC
aC
aC
aC
aC
aC
aC
aC
aC
"}
(35,1,1) = {"
aC
ac
af
af
ac
af
af
af
af
aC
aC
aC
aC
aC
aC
aC
aC
aC
aC
aC
aC
aC
aC
aC
aC
aC
aC
aC
aC
aC
aC
aC
aC
"}
(36,1,1) = {"
aC
ac
NV
af
dJ
af
ac
ac
ad
aC
aC
aC
aC
aC
aC
aC
aC
aC
aC
aC
aC
aC
aC
aC
aC
aC
aC
aC
aC
aC
aC
aC
aC
"}
(37,1,1) = {"
aC
ac
ac
af
af
af
ac
ac
af
af
aC
aC
aC
aC
aC
aC
aC
aC
aC
aC
aC
aC
aC
aC
aC
aC
aC
aC
aC
aC
aC
aC
aC
"}
(38,1,1) = {"
aC
aC
ac
af
af
af
af
af
af
ad
aC
aC
aC
aC
aC
aC
aC
aC
aC
aC
aC
aC
aC
aC
aC
aC
aC
aC
aC
aC
aC
aC
aC
"}
(39,1,1) = {"
aC
aC
ac
af
ad
aH
af
ad
aG
af
aC
aC
aC
aC
aC
aC
aC
aC
aC
aC
aC
aC
aC
aC
aC
aC
aC
aC
aC
aC
aC
aC
aC
"}
(40,1,1) = {"
aC
aC
ac
ac
NV
af
af
af
NV
af
af
aC
aC
aC
aC
aC
aC
aC
aC
aC
aC
aC
aC
aC
aC
aC
aC
aC
aC
aC
aC
aC
aC
"}
(41,1,1) = {"
aC
aC
aC
ac
af
af
ac
ac
af
af
ad
aC
aC
aC
aC
aC
aC
aC
aC
aC
aC
aC
aC
aC
aC
aC
aC
aC
aC
aC
aC
aC
aC
"}
(42,1,1) = {"
aC
aC
aC
ac
ad
af
ac
ac
af
ac
af
aC
aC
aC
aC
aC
aC
aC
aC
aC
aC
aC
aC
aC
aU
aU
aU
aU
aU
aU
aU
aU
aU
"}
(43,1,1) = {"
aC
aC
aC
ac
af
af
af
af
af
af
af
aC
aC
aC
aC
aC
aC
aC
aC
aC
aC
aC
aC
aC
aU
aC
aC
aC
aC
aC
aC
ac
ay
"}
(44,1,1) = {"
aC
aC
aC
ac
NV
af
ac
ad
af
af
ad
aC
aC
aC
aC
aC
aC
aC
aC
aC
aC
aC
aC
aC
aU
aC
aC
aC
ac
ac
ac
ac
ae
"}
(45,1,1) = {"
aC
aC
aC
ac
ac
NV
af
af
NV
af
af
NV
aC
aC
aC
aC
aC
aC
aC
aC
aC
aC
aC
aC
aU
aC
aC
ac
ac
ad
af
af
aO
"}
(46,1,1) = {"
aC
aC
aC
aC
ac
ad
ad
af
ac
ac
ad
af
aC
aC
aC
aC
aC
aC
aC
aC
aC
aC
aC
aC
aU
aC
aC
ac
af
af
af
aB
ae
"}
(47,1,1) = {"
aC
aC
aC
aC
ac
af
af
af
ac
ac
af
af
aC
aC
aC
aC
aC
aC
aC
aC
aC
aC
aC
aC
aU
aC
aC
ac
ad
af
af
af
ae
"}
(48,1,1) = {"
aC
aC
aC
aC
ac
af
af
af
af
af
af
af
aC
aC
aC
aC
aC
aC
aC
aC
aC
aC
aC
aC
aU
aC
aC
ac
ac
af
af
af
aO
"}
(49,1,1) = {"
aC
aC
aC
aC
ac
NV
ad
af
af
ad
af
dJ
af
aC
aC
aC
aC
aC
aC
aC
aC
aC
aC
aC
aU
aC
aC
aC
ac
af
af
ad
ae
"}
(50,1,1) = {"
aC
aC
aC
aC
aC
af
ac
ac
af
af
ac
ac
NV
aC
aC
aC
aC
aC
aC
aC
aC
aC
aC
aC
aU
aC
aC
aC
ac
ac
af
af
ae
"}
(51,1,1) = {"
aC
aC
aC
aC
aC
af
ac
ac
af
af
ac
ac
af
ad
aC
aC
aC
aC
aC
aC
aC
aC
aC
aC
aU
aC
aC
aC
aC
ac
ac
ac
ay
"}
(52,1,1) = {"
aC
aC
aC
aC
aC
af
NV
af
af
af
af
af
af
af
ac
aC
aC
aC
aC
aC
aC
aC
aC
aC
aU
aU
aU
aU
aU
aU
aU
aU
aU
"}
(53,1,1) = {"
aC
aC
aC
aC
aC
NV
af
af
af
ad
af
af
dJ
af
ac
ac
aC
aC
aC
aC
aC
aC
aC
aC
aC
aC
aC
aC
aC
aC
aC
aC
aC
"}
(54,1,1) = {"
aC
aC
aC
aC
aC
ac
ad
af
ac
ac
af
af
ac
NV
af
ac
aC
aC
aC
aC
aC
aC
aC
aC
aC
aC
aC
aC
aC
aC
aC
aC
aC
"}
(55,1,1) = {"
aC
aC
aC
aC
aC
ac
af
af
ac
ac
af
af
af
af
af
ac
ac
aC
aC
aC
aC
aC
aC
aC
aC
aC
aC
aC
aC
aC
aC
aC
aC
"}
(56,1,1) = {"
aC
aC
aC
aC
aC
ac
NV
af
af
af
af
af
af
NV
ad
NV
ac
ac
aC
aC
aC
aC
aC
aC
aC
aC
aC
aC
aC
aC
aC
aC
aC
"}
(57,1,1) = {"
aC
aC
aC
aC
aC
ac
af
ad
af
aH
af
ad
af
ac
af
af
af
ac
aC
aC
aC
aC
aC
aC
aC
aC
aC
aC
aC
aC
aC
aC
aC
"}
(58,1,1) = {"
aC
aC
aC
aC
aC
ac
af
af
af
ad
af
af
ac
ac
ac
af
af
ac
ac
aC
aC
aC
aC
aC
aC
aC
aC
aC
aC
aC
aC
aC
aC
"}
(59,1,1) = {"
aC
aC
aC
aC
aC
aC
NV
aG
af
NV
af
af
af
ac
af
af
ad
af
af
aC
aC
aC
aC
aC
aC
aC
aC
aC
aC
aC
aC
aC
aC
"}
(60,1,1) = {"
aC
aC
aC
aC
aC
aC
ad
af
ac
ac
NV
ad
af
af
af
NV
af
af
ad
NV
aC
aC
aC
aC
aC
aC
aC
aC
aC
aC
aC
aC
aC
"}
(61,1,1) = {"
aC
aC
aC
aC
aC
aC
af
af
ac
ac
af
af
af
af
ad
af
ac
ac
af
af
af
aC
aC
aC
aC
aC
aC
aC
aC
aC
aC
aC
aC
"}
(62,1,1) = {"
aC
aC
aC
aC
aC
aC
aC
af
af
af
aT
af
ac
af
af
af
ac
ac
af
ad
af
af
aC
aC
aC
aC
aC
aC
aC
aC
aC
aC
aC
"}
(63,1,1) = {"
aC
aC
aC
aC
aC
aC
aC
af
ad
af
af
af
ac
af
af
af
ad
af
af
af
ad
af
af
aC
aC
aC
aC
aC
aC
aC
aC
aC
aC
"}
(64,1,1) = {"
aC
aC
aC
aC
aC
aC
aC
aC
af
af
ad
af
af
ad
af
af
NV
af
ad
NV
af
aG
NV
ad
aC
aC
aC
aC
aC
aC
aC
aC
aC
"}
(65,1,1) = {"
aC
aC
aC
aC
aC
aC
aC
aC
NV
af
NV
af
af
NV
aG
NV
aC
aC
af
af
ac
ac
af
af
af
aC
aC
aC
aC
aC
aC
aC
aC
"}
(66,1,1) = {"
aC
aC
aC
aC
aC
aC
aC
aC
aC
af
af
ac
ac
af
af
aC
aC
aC
aC
af
af
af
ad
af
af
ac
aC
aC
aM
aM
aM
aM
aC
"}
(67,1,1) = {"
aC
aC
aC
aC
aC
aC
aC
aC
aC
ad
af
ac
ac
af
af
aC
aC
aC
aC
af
ad
af
NV
ad
af
ac
aC
aC
aM
aM
aM
aM
aC
"}
(68,1,1) = {"
aC
aC
aC
aC
aC
aC
aC
aC
aC
af
af
af
af
af
aC
aC
aC
aC
aC
aC
af
NV
ac
ac
af
af
aC
aC
aM
aM
aM
aM
aC
"}
(69,1,1) = {"
aC
aC
aC
aC
aC
aC
aC
aC
aC
aC
af
af
af
ad
aC
aC
aC
aC
aC
aC
af
af
ac
ac
af
ad
aC
aC
aC
aC
aC
aC
aC
"}
(70,1,1) = {"
aC
aC
aC
aC
aC
aC
aC
aC
aC
aC
af
ac
ac
NV
aC
aC
aC
aC
aC
aC
aC
af
af
af
af
af
aC
aC
aM
aM
aM
aM
aC
"}
(71,1,1) = {"
aM
aM
aM
aM
aC
aM
aM
aM
aM
aC
NV
af
af
af
NV
aC
aC
aC
aC
aC
aC
NV
ad
af
af
dJ
aC
aC
aM
aM
aM
aM
aC
"}
(72,1,1) = {"
aM
aM
aM
aM
aC
aM
aM
aM
aM
aC
ZQ
ZQ
ZQ
ZQ
ZQ
aC
aC
aC
aC
aC
aC
ZQ
ZQ
ZQ
ZQ
ZQ
aC
aC
aM
aM
aM
aM
aC
"}
(73,1,1) = {"
aM
aM
aM
aM
aC
aM
aM
aM
aM
aC
ar
aW
ar
ar
aW
aC
aC
aC
aC
aC
ar
ar
ar
ar
ar
ar
aC
aC
aC
aC
aC
aC
aC
"}
(74,1,1) = {"
aM
aM
aM
aM
aC
aM
aM
aM
aM
aC
ar
ar
VY
ar
ar
aC
aC
aC
aC
aC
ar
aW
ar
aC
aC
aC
aC
dl
aL
aX
ao
Pf
aL
"}
(75,1,1) = {"
aC
aC
aC
aC
aC
aC
aC
aC
aC
aC
ar
aW
ar
ar
aW
aC
aC
aC
aC
ar
ar
ar
ar
ar
aC
aC
aC
bq
aq
ax
aV
aR
aq
"}
(76,1,1) = {"
aM
aM
aM
aM
aC
aM
aM
aM
aM
aC
ar
ar
ar
ar
ar
ar
aC
aC
ar
ar
ar
ar
ar
aW
aC
aC
aC
bq
aq
ab
aV
az
as
"}
(77,1,1) = {"
aM
aM
aM
aM
aC
aM
aM
aM
aM
aC
ar
ar
aS
aS
ar
ar
aC
aJ
ar
ar
aW
aJ
ar
aC
aC
aC
aC
bq
aq
ak
aD
ag
as
"}
(78,1,1) = {"
aM
aM
aM
aM
aC
aM
aM
aM
aM
aC
aC
ar
ar
ar
ar
ar
ar
ar
ar
aS
aS
ar
aC
aC
aC
aC
aC
bq
aq
aP
aV
av
as
"}
(79,1,1) = {"
aC
aC
aC
aC
aC
aC
aC
aC
aC
aC
aC
aC
ar
aW
aJ
aW
ar
eP
ar
aS
aS
ar
aC
aC
aC
aC
aC
bq
aq
an
aj
an
as
"}
(80,1,1) = {"
aM
aM
aM
aM
aC
aM
aM
aM
aM
aC
aC
aC
aC
ar
ar
ar
ar
ar
ar
aW
ar
ar
ZQ
ar
aC
aC
aC
bq
aC
aI
aI
aK
aI
"}
