//MAP CONVERTED BY dmm2tgm.py THIS HEADER COMMENT PREVENTS RECONVERSION, DO NOT REMOVE
"al" = (
/obj/effect/landmark/weapon_spawn/tier2_weapon_spawn,
/obj/structure/stairs/seamless/edge{
	dir = 8
	},
/turf/open/floor/tile/dark,
/area/deathmatch)
"ay" = (
/obj/effect/landmark/weapon_spawn/tier3_weapon_spawn,
/turf/open/floor/plating/asteroidfloor,
/area/deathmatch)
"bi" = (
/turf/open/floor/plating/ground/mars/random/dirt,
/area/deathmatch)
"db" = (
/obj/effect/landmark/weapon_spawn/tier2_weapon_spawn,
/turf/open/floor/plating/ground/mars/random/sand,
/area/deathmatch)
"dh" = (
/obj/structure/cargo_container/wy{
	dir = 4
	},
/turf/open/floor/plating/ground/mars/random/sand,
/area/deathmatch)
"dj" = (
/turf/open/floor/plating/ground/mars/random/sand,
/area/deathmatch)
"dl" = (
/obj/effect/turf_decal/sandytile/sandyplating,
/turf/closed/wall,
/area/deathmatch)
"dA" = (
/obj/item/storage/belt/champion,
/turf/open/floor/grime,
/area/deathmatch)
"dB" = (
/obj/effect/landmark/deathmatch,
/turf/open/floor/plating/asteroidplating,
/area/deathmatch)
"dD" = (
/obj/effect/landmark/weapon_spawn/tier2_weapon_spawn,
/turf/open/floor/plating/ground/mars/dirttosand{
	dir = 1
	},
/area/deathmatch)
"dO" = (
/turf/open/floor/plating/asteroidplating{
	color = "#888888"
	},
/area/deathmatch)
"fF" = (
/obj/structure/rack,
/obj/effect/spawner/random/misc/plushie/nospawnninetyfive,
/turf/open/floor/plating/asteroidplating,
/area/deathmatch)
"hw" = (
/obj/effect/landmark/deathmatch,
/turf/open/floor/plating/ground/mars/random/dirt,
/area/deathmatch)
"ie" = (
/obj/structure/stairs/seamless/edge{
	color = "#888888"
	},
/turf/open/floor/tile/dark,
/area/deathmatch)
"iv" = (
/obj/structure/cargo_container/wy{
	dir = 1
	},
/turf/open/floor/plating/asteroidplating,
/area/deathmatch)
"ix" = (
/obj/structure/rack,
/obj/effect/landmark/weapon_spawn/tier3_weapon_spawn,
/turf/open/floor/plating/asteroidfloor,
/area/deathmatch)
"iZ" = (
/obj/effect/landmark/weapon_spawn/tier3_weapon_spawn,
/obj/structure/stairs/seamless{
	color = "#888888";
	dir = 8
	},
/turf/open/floor/tile/dark,
/area/deathmatch)
"jc" = (
/obj/machinery/door/poddoor/railing{
	dir = 1
	},
/turf/open/floor/plating/asteroidwarning{
	dir = 1
	},
/area/deathmatch)
"jJ" = (
/obj/effect/landmark/weapon_spawn/tier2_weapon_spawn,
/turf/open/floor/plating/ground/mars/dirttosand{
	dir = 9
	},
/area/deathmatch)
"jM" = (
/obj/effect/spawner/random/engineering/ore_box,
/turf/open/floor/plating/ground/mars/dirttosand,
/area/deathmatch)
"jP" = (
/obj/machinery/door/poddoor/railing,
/turf/open/floor/plating/asteroidfloor,
/area/deathmatch)
"jU" = (
/obj/structure/window/framed/mainship/hull,
/obj/structure/window/framed/wood,
/turf/open/floor/wood,
/area/deathmatch)
"kR" = (
/obj/structure/prop/mainship/hangar_stencil/two,
/turf/open/floor/plating/asteroidplating,
/area/deathmatch)
"lY" = (
/obj/structure/stairs/seamless{
	color = "#888888";
	dir = 8
	},
/turf/open/floor/tile/dark,
/area/deathmatch)
"nk" = (
/obj/machinery/door/window{
	dir = 8
	},
/obj/effect/ai_node,
/turf/open/floor/grime,
/area/deathmatch)
"nt" = (
/obj/effect/spawner/random/engineering/ore_box,
/turf/open/floor/plating/ground/mars/dirttosand{
	dir = 8
	},
/area/deathmatch)
"od" = (
/turf/closed/wall,
/area/deathmatch)
"oD" = (
/obj/effect/decal/cleanable/rune,
/obj/item/explosive/plastique,
/turf/open/floor/plating/asteroidplating,
/area/deathmatch)
"oH" = (
/obj/structure/largecrate/random/barrel/yellow,
/turf/open/floor/plating/asteroidfloor,
/area/deathmatch)
"pV" = (
/obj/effect/landmark/weapon_spawn/tier2_weapon_spawn,
/turf/open/floor/plating/ground/mars/dirttosand,
/area/deathmatch)
"pX" = (
/obj/structure/largecrate,
/turf/open/floor/plating/ground/mars/random/sand,
/area/deathmatch)
"qF" = (
/obj/structure/window/framed/mainship/hull,
/obj/structure/window/framed/wood,
/turf/open/floor/mainship/mono,
/area/deathmatch)
"rv" = (
/obj/machinery/door/poddoor/railing,
/turf/open/floor/plating/asteroidplating,
/area/deathmatch)
"sr" = (
/obj/effect/landmark/weapon_spawn/tier2_weapon_spawn,
/turf/open/floor/plating/ground/mars/random/dirt,
/area/deathmatch)
"sw" = (
/obj/structure/largecrate,
/turf/open/floor/plating/ground/mars/dirttosand{
	dir = 10
	},
/area/deathmatch)
"tf" = (
/obj/structure/largecrate,
/turf/open/floor/plating/asteroidplating,
/area/deathmatch)
"tF" = (
/obj/structure/rack,
/turf/open/floor/plating/asteroidplating,
/area/deathmatch)
"tZ" = (
/obj/structure/rack,
/turf/open/floor/plating/asteroidfloor,
/area/deathmatch)
"up" = (
/turf/open/floor/plating/ground/mars/dirttosand{
	dir = 10
	},
/area/deathmatch)
"vi" = (
/obj/effect/landmark/deathmatch,
/turf/open/floor/plating/ground/mars/dirttosand{
	dir = 6
	},
/area/deathmatch)
"vv" = (
/turf/open/floor/plating/ground/mars/dirttosand{
	dir = 9
	},
/area/deathmatch)
"wl" = (
/obj/structure/cargo_container/ch_red{
	dir = 4
	},
/turf/open/floor/plating/ground/mars/random/sand,
/area/deathmatch)
"ww" = (
/turf/closed/wall/wood,
/area/deathmatch)
"wH" = (
/obj/machinery/door/poddoor/railing{
	dir = 1
	},
/obj/effect/landmark/weapon_spawn/tier2_weapon_spawn,
/turf/open/floor/plating/asteroidwarning{
	dir = 1
	},
/area/deathmatch)
"wI" = (
/obj/effect/landmark/weapon_spawn/tier2_weapon_spawn,
/turf/open/floor/plating/asteroidplating,
/area/deathmatch)
"xt" = (
/obj/effect/landmark/deathmatch,
/obj/structure/stairs/seamless{
	dir = 8
	},
/turf/open/floor/tile/dark,
/area/deathmatch)
"xB" = (
/obj/structure/cargo_container/wy{
	dir = 4
	},
/turf/open/floor/plating/asteroidplating,
/area/deathmatch)
"yt" = (
/obj/machinery/door/poddoor/railing{
	dir = 1
	},
/obj/structure/stairs/seamless/edge{
	color = "#888888";
	dir = 4
	},
/turf/open/floor/tile/dark,
/area/deathmatch)
"yA" = (
/obj/structure/stairs/seamless/edge,
/turf/open/floor/tile/dark,
/area/deathmatch)
"zr" = (
/obj/structure/cargo_container{
	dir = 1
	},
/turf/open/floor/plating/ground/mars/random/dirt,
/area/deathmatch)
"zB" = (
/obj/structure/window/framed/mainship/requisitions,
/obj/structure/window/framed/wood,
/turf/open/floor/wood,
/area/deathmatch)
"zQ" = (
/obj/effect/spawner/random/engineering/ore_box,
/turf/open/floor/plating/ground/mars/random/dirt,
/area/deathmatch)
"Ab" = (
/obj/effect/landmark/weapon_spawn/tier2_weapon_spawn,
/turf/open/floor/plating/asteroidplating{
	color = "#888888"
	},
/area/deathmatch)
"Aw" = (
/obj/structure/platform{
	dir = 1
	},
/turf/closed/wall,
/area/deathmatch)
"Ax" = (
/obj/effect/landmark/weapon_spawn/tier3_weapon_spawn,
/turf/open/floor/plating/ground/mars/random/sand,
/area/deathmatch)
"AA" = (
/obj/structure/stairs/seamless/edge{
	dir = 8
	},
/turf/open/floor/tile/dark,
/area/deathmatch)
"AF" = (
/obj/structure/cargo_container/ch_red{
	dir = 1
	},
/turf/open/floor/plating/ground/mars/random/sand,
/area/deathmatch)
"DQ" = (
/obj/machinery/door/poddoor/railing{
	dir = 2
	},
/obj/structure/stairs/seamless/edge{
	color = "#888888"
	},
/turf/open/floor/tile/dark,
/area/deathmatch)
"Ei" = (
/obj/structure/platform{
	dir = 1
	},
/turf/open/floor/plating/asteroidfloor,
/area/deathmatch)
"Fc" = (
/obj/structure/table/reinforced,
/turf/open/floor/plating/asteroidfloor,
/area/deathmatch)
"Fm" = (
/obj/effect/decal/cleanable/rune,
/turf/open/floor/plating/asteroidplating,
/area/deathmatch)
"Fp" = (
/turf/open/floor/plating/asteroidplating,
/area/deathmatch)
"FZ" = (
/turf/closed/mineral/smooth/desertdamrockwall/indestructible,
/area/deathmatch)
"Go" = (
/obj/effect/landmark/deathmatch,
/turf/open/floor/plating/ground/mars/random/sand,
/area/deathmatch)
"Gz" = (
/obj/machinery/door/window/right,
/turf/open/floor/grime,
/area/deathmatch)
"GJ" = (
/obj/machinery/door/poddoor/railing{
	dir = 8
	},
/turf/open/floor/plating/asteroidwarning{
	dir = 8
	},
/area/deathmatch)
"GO" = (
/obj/structure/stairs/seamless{
	dir = 8
	},
/turf/open/floor/tile/dark,
/area/deathmatch)
"HB" = (
/obj/structure/stairs/seamless/edge{
	dir = 4
	},
/turf/open/floor/tile/dark,
/area/deathmatch)
"HV" = (
/obj/structure/window/framed/wood,
/turf/open/floor/wood,
/area/deathmatch)
"Ib" = (
/obj/effect/landmark/weapon_spawn/tier2_weapon_spawn,
/obj/structure/stairs/seamless/edge{
	dir = 1
	},
/turf/open/floor/tile/dark,
/area/deathmatch)
"Ip" = (
/turf/open/floor/plating/ground/mars/dirttosand,
/area/deathmatch)
"Ix" = (
/obj/structure/cargo_container/wy,
/turf/open/floor/plating/asteroidplating,
/area/deathmatch)
"Jf" = (
/turf/open/floor/plating/ground/mars/dirttosand{
	dir = 5
	},
/area/deathmatch)
"Jn" = (
/obj/effect/spawner/random/engineering/ore_box,
/turf/open/floor/plating/asteroidplating,
/area/deathmatch)
"JT" = (
/turf/open/floor/grime,
/area/deathmatch)
"JW" = (
/obj/machinery/door/poddoor/railing{
	dir = 8
	},
/obj/effect/landmark/weapon_spawn/tier3_weapon_spawn,
/turf/open/floor/plating/asteroidwarning{
	dir = 8
	},
/area/deathmatch)
"Kz" = (
/obj/structure/cargo_container/wy{
	dir = 1
	},
/turf/open/floor/plating/ground/mars/random/sand,
/area/deathmatch)
"KZ" = (
/turf/open/floor/plating/ground/mars/dirttosand{
	dir = 4
	},
/area/deathmatch)
"Lt" = (
/obj/structure/cargo_container/wy,
/turf/open/floor/plating/ground/mars/random/sand,
/area/deathmatch)
"Lv" = (
/obj/machinery/door/poddoor/railing{
	dir = 2
	},
/obj/machinery/door/poddoor/railing{
	dir = 8
	},
/turf/open/floor/plating/asteroidfloor,
/area/deathmatch)
"Mn" = (
/turf/open/floor/plating/asteroidfloor,
/area/deathmatch)
"Mx" = (
/obj/structure/rack,
/turf/open/floor/plating/ground/mars/random/sand,
/area/deathmatch)
"My" = (
/obj/effect/landmark/deathmatch,
/turf/open/floor/plating/asteroidfloor,
/area/deathmatch)
"MV" = (
/obj/effect/landmark/weapon_spawn/tier2_weapon_spawn,
/turf/open/floor/plating/asteroidfloor,
/area/deathmatch)
"Pa" = (
/obj/effect/forcefield{
	desc = "You can't get in. Heh.";
	name = "Blocker"
	},
/turf/closed/wall/r_wall/unmeltable/regular,
/area/deathmatch)
"Pv" = (
/obj/structure/fence,
/turf/open/floor/plating/ground/mars/random/sand,
/area/deathmatch)
"PF" = (
/turf/open/floor/plating/ground/mars/dirttosand{
	dir = 1
	},
/area/deathmatch)
"QE" = (
/obj/effect/landmark/weapon_spawn/tier5_weapon_spawn,
/turf/open/floor/plating/ground/mars/dirttosand,
/area/deathmatch)
"QN" = (
/obj/structure/prop/mainship/hangar_stencil,
/turf/open/floor/plating/asteroidplating,
/area/deathmatch)
"QO" = (
/obj/structure/largecrate,
/turf/open/floor/plating/asteroidfloor,
/area/deathmatch)
"QR" = (
/obj/structure/platform{
	dir = 9
	},
/turf/open/floor/plating/asteroidfloor,
/area/deathmatch)
"RI" = (
/obj/machinery/door/poddoor/railing{
	dir = 1
	},
/obj/structure/stairs/seamless{
	color = "#888888";
	dir = 8
	},
/turf/open/floor/tile/dark,
/area/deathmatch)
"Sf" = (
/obj/machinery/door/poddoor/railing{
	dir = 2
	},
/turf/open/floor/plating/asteroidwarning,
/area/deathmatch)
"Sp" = (
/obj/effect/landmark/weapon_spawn/tier2_weapon_spawn,
/obj/structure/stairs/seamless{
	dir = 8
	},
/turf/open/floor/tile/dark,
/area/deathmatch)
"Uc" = (
/obj/machinery/door/poddoor/railing{
	dir = 2
	},
/turf/open/floor/plating/asteroidfloor,
/area/deathmatch)
"VQ" = (
/obj/structure/cargo_container/ch_red,
/turf/open/floor/plating/ground/mars/random/sand,
/area/deathmatch)
"VU" = (
/obj/effect/landmark/deathmatch,
/turf/open/floor/grime,
/area/deathmatch)
"Wa" = (
/obj/machinery/door/poddoor/railing{
	dir = 8
	},
/turf/open/floor/plating/asteroidfloor,
/area/deathmatch)
"Wj" = (
/obj/structure/window/framed/colony,
/turf/open/floor/plating,
/area/deathmatch)
"WO" = (
/obj/effect/landmark/deathmatch,
/obj/structure/platform{
	dir = 1
	},
/turf/open/floor/plating/asteroidfloor,
/area/deathmatch)
"Xa" = (
/obj/structure/stairs/seamless{
	dir = 4
	},
/turf/open/floor/tile/dark,
/area/deathmatch)
"Xe" = (
/turf/open/floor/plating/ground/mars/dirttosand{
	dir = 8
	},
/area/deathmatch)
"XI" = (
/turf/open/floor/plating/ground/mars/dirttosand{
	dir = 6
	},
/area/deathmatch)
"XK" = (
/obj/structure/stairs/seamless/edge{
	dir = 1
	},
/turf/open/floor/tile/dark,
/area/deathmatch)
"XY" = (
/turf/closed/mineral/smooth/desertdamrockwall,
/area/deathmatch)
"YE" = (
/obj/structure/largecrate,
/turf/open/floor/plating/ground/mars/random/dirt,
/area/deathmatch)
"YK" = (
/obj/machinery/door/poddoor/railing{
	dir = 2
	},
/obj/effect/landmark/weapon_spawn/tier3_weapon_spawn,
/turf/open/floor/plating/asteroidfloor,
/area/deathmatch)
"YO" = (
/obj/structure/stairs/edge{
	dir = 4
	},
/turf/open/floor/tile/dark,
/area/deathmatch)
"ZA" = (
/obj/structure/table/reinforced,
/obj/effect/spawner/random/misc/plushie/nospawnninetyfive,
/turf/open/floor/plating/asteroidfloor,
/area/deathmatch)
"ZH" = (
/obj/effect/forcefield{
	desc = "You can't get in. Heh.";
	name = "Blocker"
	},
/obj/machinery/door/poddoor/mainship/ammo,
/turf/open/floor/plating/ground/mars/random/sand,
/area/deathmatch)
"ZI" = (
/obj/effect/landmark/deathmatch,
/turf/open/floor/plating/ground/mars/dirttosand,
/area/deathmatch)
"ZO" = (
/obj/effect/landmark/deathmatch,
/turf/open/floor/plating/asteroidplating{
	color = "#888888"
	},
/area/deathmatch)
"ZT" = (
/obj/effect/landmark/weapon_spawn/tier2_weapon_spawn,
/turf/open/floor/plating/ground/mars/dirttosand{
	dir = 8
	},
/area/deathmatch)

(1,1,1) = {"
FZ
FZ
FZ
FZ
FZ
FZ
FZ
FZ
FZ
FZ
FZ
FZ
FZ
FZ
FZ
FZ
FZ
FZ
FZ
FZ
FZ
FZ
FZ
FZ
FZ
FZ
FZ
FZ
FZ
FZ
FZ
FZ
FZ
FZ
FZ
FZ
Pa
Pa
Pa
Pa
Pa
FZ
FZ
FZ
FZ
FZ
"}
(2,1,1) = {"
FZ
XY
XY
XY
XY
XY
XY
XY
XY
XY
XY
XY
XY
XY
XY
XY
XY
XY
XY
XY
XY
XY
XY
XY
XY
XY
XY
XY
XY
XY
od
od
od
od
od
od
od
MV
My
Mn
od
od
od
od
od
Pa
"}
(3,1,1) = {"
FZ
XY
XY
XY
XY
XY
XY
XY
XY
XY
XY
XY
XY
XY
XY
XY
XY
XY
XY
XY
XY
XY
XY
XY
XY
XY
XY
XY
XY
XY
od
Mn
Mn
My
Mn
Mn
Mn
Mn
Mn
Mn
MV
Mn
Mn
Mn
Mn
Pa
"}
(4,1,1) = {"
FZ
XY
XY
XY
XY
XY
XY
XY
XY
XY
XY
XY
XY
XY
XY
XY
XY
XY
XY
XY
XY
XY
XY
XY
XY
XY
XY
XY
XY
XY
od
Mn
Mn
Mn
MV
Mn
Mn
Mn
Mn
Mn
Mn
My
Mn
MV
Mn
Pa
"}
(5,1,1) = {"
FZ
XY
XY
XY
XY
XY
XY
XY
XY
XY
XY
XY
XY
XY
XY
XY
XY
XY
XY
XY
XY
XY
XY
XY
XY
XY
XY
XY
XY
XY
od
Mn
Mn
od
od
od
od
od
od
od
od
od
od
Mn
Mn
Pa
"}
(6,1,1) = {"
FZ
XY
XY
XY
XY
XY
XY
XY
XY
XY
XY
XY
XY
XY
XY
XY
XY
XY
XY
XY
XY
XY
XY
XY
XY
XY
XY
XY
XY
XY
od
MV
Mn
od
od
Mn
jP
jP
jP
jP
jP
Mn
od
Mn
Mn
Pa
"}
(7,1,1) = {"
FZ
XY
XY
XY
XY
XY
XY
XY
XY
XY
XY
XY
XY
XY
XY
XY
XY
XY
XY
XY
XY
XY
XY
XY
XY
XY
XY
XY
XY
XY
od
GO
yA
od
od
Sf
Fp
Fp
Fp
Fp
dB
jc
od
Mn
Mn
Pa
"}
(8,1,1) = {"
FZ
XY
XY
XY
XY
XY
XY
XY
XY
XY
XY
XY
XY
XY
XY
XY
XY
Pv
Pv
Pv
Pv
Pv
Pv
Pv
Pv
XY
XY
XY
XY
XY
od
GO
GO
od
od
Sf
wI
Fp
oD
Fp
Fp
jc
od
Mn
MV
Pa
"}
(9,1,1) = {"
FZ
XY
XY
XY
XY
XY
XY
XY
XY
XY
XY
XY
XY
XY
XY
XY
dj
dj
dj
dj
vv
Xe
Xe
up
dj
Ax
XY
XY
XY
XY
od
xt
GO
od
od
Sf
Fp
Fp
Fp
Fp
Fp
jc
Mn
Mn
Mn
Pa
"}
(10,1,1) = {"
FZ
XY
XY
XY
XY
XY
XY
XY
XY
XY
XY
XY
XY
XY
XY
dj
vv
Xe
ZT
Xe
bi
bi
hw
bi
up
dj
XY
XY
XY
XY
od
GO
Sp
od
od
Sf
Fp
fF
tf
kR
Fp
jc
Mn
Mn
Mn
Pa
"}
(11,1,1) = {"
FZ
XY
XY
XY
XY
XY
XY
XY
XY
XY
XY
XY
XY
vv
Xe
Xe
bi
bi
bi
bi
bi
bi
bi
bi
sr
up
dj
dj
od
XY
od
GO
GO
od
od
Sf
Fp
tf
tf
Fp
Fp
jc
Mn
MV
My
Pa
"}
(12,1,1) = {"
FZ
XY
XY
XY
XY
XY
XY
XY
XY
XY
XY
XY
vv
sr
bi
bi
hw
bi
bi
zr
bi
bi
bi
bi
bi
Ip
dj
Go
od
od
od
GO
GO
od
od
Sf
Fp
Fp
Fp
Fp
Fp
wH
Mn
Mn
Mn
Pa
"}
(13,1,1) = {"
FZ
XY
XY
XY
XY
XY
XY
XY
XY
XY
XY
vv
bi
bi
bi
bi
bi
bi
bi
zr
zQ
bi
bi
bi
bi
bi
Xe
od
od
Mn
Uc
GO
GO
od
od
Sf
dB
Fp
wI
Fp
Fp
jc
od
Mn
od
Pa
"}
(14,1,1) = {"
FZ
XY
XY
XY
XY
XY
XY
XY
XY
vv
bi
bi
bi
bi
hw
bi
bi
bi
bi
bi
bi
bi
hw
bi
bi
bi
bi
sr
Fp
Mn
Uc
GO
xt
od
od
Sf
Fp
Fp
Fp
Fp
Fp
jc
od
MV
Mn
Pa
"}
(15,1,1) = {"
FZ
XY
XY
XY
XY
XY
XY
XY
jJ
bi
bi
bi
KZ
KZ
KZ
bi
sr
ww
HV
HV
nk
qF
qF
ww
sr
bi
bi
bi
od
Mn
Mn
Mn
Mn
od
od
Sf
Fp
HB
GO
yA
Fp
jc
od
Fc
ix
Pa
"}
(16,1,1) = {"
FZ
XY
XY
XY
XY
XY
XY
vv
bi
bi
bi
XI
XY
XY
XY
Jf
KZ
zB
VU
JT
JT
JT
VU
jU
bi
bi
bi
hw
od
My
Mn
MV
Mn
od
od
Mn
Wa
Mn
Mn
Mn
Wa
Mn
od
od
od
Pa
"}
(17,1,1) = {"
FZ
XY
XY
XY
XY
XY
XY
PF
bi
bi
vi
XY
XY
XY
XY
dj
dj
zB
JT
JT
JT
JT
JT
jU
bi
bi
bi
Ip
od
od
Mn
Mn
My
od
od
od
od
dO
Ab
dO
od
od
od
XY
XY
FZ
"}
(18,1,1) = {"
FZ
XY
XY
XY
XY
XY
XY
PF
sr
Ip
XY
XY
XY
XY
XY
XY
db
zB
JT
JT
dA
JT
JT
jU
bi
bi
bi
QE
Lt
od
Mn
Mn
Mn
od
XY
od
dO
dO
dO
dO
dO
od
XY
XY
XY
FZ
"}
(19,1,1) = {"
FZ
XY
XY
XY
XY
XY
XY
PF
bi
XI
XY
XY
XY
XY
XY
XY
Ax
zB
JT
JT
JT
JT
JT
jU
KZ
bi
bi
Ip
Kz
od
Mn
Mn
oH
od
XY
od
dO
od
od
od
dO
od
XY
XY
XY
FZ
"}
(20,1,1) = {"
FZ
XY
XY
XY
XY
XY
vv
bi
Ip
XY
XY
XY
XY
XY
XY
XY
XY
zB
VU
JT
JT
JT
VU
jU
od
bi
bi
Ip
dh
od
Fp
Fp
od
od
XY
od
dO
dO
dO
dO
ZO
od
XY
XY
XY
FZ
"}
(21,1,1) = {"
FZ
XY
XY
XY
XY
XY
PF
hw
Ip
dj
dj
XY
od
od
od
od
od
ww
zB
zB
Gz
jU
jU
ww
od
bi
sr
bi
nt
Xe
bi
ZI
dj
dj
XY
od
od
lY
lY
ie
od
od
XY
XY
XY
FZ
"}
(22,1,1) = {"
FZ
XY
XY
XY
XY
XY
PF
bi
XI
VQ
dj
dj
od
Mn
Mn
Mn
My
Mn
Mn
Fp
Fp
Fp
Fp
Fp
od
bi
bi
bi
bi
bi
bi
Ip
dj
XY
XY
XY
od
lY
iZ
ie
od
XY
XY
XY
XY
FZ
"}
(23,1,1) = {"
FZ
XY
XY
XY
XY
dj
dD
Ip
dj
AF
Go
dj
od
Mn
Mn
Mn
Mn
Mn
Mn
Fp
dB
Fp
wI
Fp
od
YE
bi
bi
bi
bi
bi
pV
XY
XY
XY
XY
od
od
od
od
od
XY
XY
XY
XY
FZ
"}
(24,1,1) = {"
FZ
XY
XY
XY
dj
vv
bi
jM
dj
wl
dj
Ax
od
Mn
Mn
Aw
od
od
od
Fp
Fp
Fp
QN
Fp
od
Lv
bi
bi
bi
bi
bi
Ip
XY
XY
XY
XY
XY
XY
XY
XY
XY
XY
XY
XY
XY
FZ
"}
(25,1,1) = {"
FZ
XY
XY
XY
dj
PF
hw
Ip
od
od
od
od
od
My
MV
Ei
Mn
Mn
Wj
Fp
Fp
Fp
Fp
Fp
od
YK
Jf
bi
hw
bi
bi
Ip
XY
XY
XY
XY
XY
XY
XY
XY
XY
XY
XY
XY
XY
FZ
"}
(26,1,1) = {"
FZ
XY
XY
XY
dj
PF
bi
Ip
od
Mn
Mn
Mn
Mn
Mn
Mn
Mn
od
Mn
Wj
Fp
Fp
Ix
Jn
Fp
od
Uc
dj
PF
bi
bi
bi
Ip
dj
dj
XY
XY
XY
XY
XY
XY
XY
XY
XY
XY
XY
FZ
"}
(27,1,1) = {"
FZ
XY
dj
dj
db
PF
bi
Ip
od
Mn
MV
Mn
Mn
Mn
Mn
Ei
od
Mn
Wj
Fp
Fp
iv
Fp
Fp
od
Uc
db
PF
bi
bi
bi
YE
sw
dj
XY
XY
XY
XY
XY
XY
XY
XY
XY
XY
XY
FZ
"}
(28,1,1) = {"
FZ
db
Go
Ax
dj
PF
hw
Ip
od
Mn
Mn
od
Mn
Mn
QR
Mn
od
YO
od
Fp
Fp
xB
Fp
dB
od
Wj
Wj
Wj
od
bi
bi
YE
Ip
db
dj
XY
XY
XY
XY
XY
XY
XY
ZH
ZH
XY
FZ
"}
(29,1,1) = {"
FZ
dj
dj
dj
dj
Jf
bi
Ip
od
Mn
Mn
od
Mn
Mn
WO
ZA
od
Fp
Fp
Fp
Fp
Fm
Fp
Fp
od
ay
Mn
Mn
od
bi
bi
bi
Ip
dj
dj
XY
XY
XY
XY
XY
XY
db
dj
dj
Ax
FZ
"}
(30,1,1) = {"
FZ
ZH
ZH
XY
XY
dj
PF
pV
od
My
Mn
od
Mn
Mn
Ei
QO
od
Fp
dB
Fp
Fp
Fp
Fp
Fp
od
od
od
Mn
od
bi
bi
bi
Ip
dj
dj
db
XY
XY
XY
XY
XY
dj
dj
dj
Go
FZ
"}
(31,1,1) = {"
FZ
XY
XY
XY
XY
dj
Jf
bi
bi
bi
sr
od
MV
Mn
Aw
od
od
Fp
wI
Fp
Fp
Fp
Fp
Fp
od
Mn
MV
Mn
Fp
bi
bi
bi
ZI
dj
dj
dj
XY
XY
XY
XY
dj
dj
dj
dj
dj
FZ
"}
(32,1,1) = {"
FZ
XY
XY
XY
XY
XY
dj
Jf
KZ
bi
bi
od
Mn
Mn
tZ
Fc
od
GJ
GJ
GJ
GJ
JW
GJ
GJ
od
tZ
Mn
My
Fp
bi
bi
bi
Ip
dj
dj
dj
XY
XY
XY
dj
dj
dj
dj
dj
dj
FZ
"}
(33,1,1) = {"
FZ
XY
XY
XY
XY
XY
dj
dj
dj
Jf
KZ
od
My
Mn
Mn
Fc
od
od
od
od
od
od
od
od
od
od
Mn
MV
od
bi
bi
KZ
XI
dj
dj
dj
dj
dj
dj
dj
Go
dj
dj
dj
dj
FZ
"}
(34,1,1) = {"
FZ
XY
XY
XY
XY
XY
XY
XY
dj
db
dj
od
Mn
Mn
Mn
Mn
od
tF
Fp
Fp
tf
Fp
Fp
tF
od
od
Mn
Mn
od
KZ
XI
dj
dj
dj
dj
dj
Go
dj
dj
dj
dj
dj
dj
db
XY
FZ
"}
(35,1,1) = {"
FZ
XY
XY
XY
XY
XY
XY
XY
XY
dj
Go
od
od
Mn
MV
Mn
Mn
dB
Fp
Fp
Fp
Fp
wI
Fp
My
Mn
Mn
Mn
od
dj
db
dj
dj
XY
dj
dj
dj
dj
dj
dj
dj
dj
dj
XY
XY
FZ
"}
(36,1,1) = {"
FZ
XY
XY
XY
XY
XY
XY
XY
XY
dj
dj
XY
od
od
Mn
Mn
Mn
Fp
Fp
wI
Fp
Fp
Fp
Fp
Mn
Mn
MV
Mn
od
XY
XY
XY
XY
XY
XY
db
dj
dj
dj
XY
XY
XY
XY
XY
XY
FZ
"}
(37,1,1) = {"
FZ
XY
XY
XY
XY
XY
XY
XY
XY
Mx
pX
XY
XY
od
od
od
od
Fp
Fp
rv
rv
rv
Fp
Fp
dl
od
od
od
od
XY
XY
XY
XY
XY
XY
XY
XY
XY
XY
XY
XY
XY
XY
XY
XY
FZ
"}
(38,1,1) = {"
FZ
XY
XY
XY
XY
XY
XY
XY
XY
XY
XY
XY
XY
XY
XY
XY
od
Xa
XK
yt
lY
DQ
Xa
XK
od
XY
XY
XY
XY
XY
XY
XY
XY
XY
XY
XY
XY
XY
XY
XY
XY
XY
XY
XY
XY
FZ
"}
(39,1,1) = {"
FZ
XY
XY
XY
XY
XY
XY
XY
XY
XY
XY
XY
XY
XY
XY
XY
od
Xa
XK
RI
iZ
DQ
Xa
XK
od
XY
XY
XY
XY
XY
XY
XY
XY
XY
XY
XY
XY
XY
XY
XY
XY
XY
XY
XY
XY
FZ
"}
(40,1,1) = {"
FZ
XY
XY
XY
XY
XY
XY
XY
XY
XY
XY
XY
XY
XY
XY
XY
od
al
XK
RI
lY
DQ
AA
Ib
od
XY
XY
XY
XY
XY
XY
XY
XY
XY
XY
XY
XY
XY
XY
XY
XY
XY
XY
XY
XY
FZ
"}
(41,1,1) = {"
FZ
XY
XY
XY
XY
XY
XY
XY
XY
XY
XY
XY
XY
XY
XY
XY
od
Fp
dB
Fp
Fp
Fp
Fp
Fp
od
XY
XY
XY
XY
XY
XY
XY
XY
XY
XY
XY
XY
XY
XY
XY
XY
XY
XY
XY
XY
FZ
"}
(42,1,1) = {"
FZ
XY
XY
XY
XY
XY
XY
XY
XY
XY
XY
XY
XY
XY
XY
XY
od
Fp
Fp
Fp
Fp
dB
Fp
Fp
od
XY
XY
XY
XY
XY
XY
XY
XY
XY
XY
XY
XY
XY
XY
XY
XY
XY
XY
XY
XY
FZ
"}
(43,1,1) = {"
FZ
XY
XY
XY
XY
XY
XY
XY
XY
XY
XY
XY
XY
XY
XY
XY
od
od
od
Fp
wI
Fp
od
od
XY
XY
XY
XY
XY
XY
XY
XY
XY
XY
XY
XY
XY
XY
XY
XY
XY
XY
XY
XY
XY
FZ
"}
(44,1,1) = {"
FZ
XY
XY
XY
XY
XY
XY
XY
XY
XY
XY
XY
XY
XY
XY
XY
XY
XY
od
Fp
Fp
Fp
od
XY
XY
XY
XY
XY
XY
XY
XY
XY
XY
XY
XY
XY
XY
XY
XY
XY
XY
XY
XY
XY
XY
FZ
"}
(45,1,1) = {"
FZ
XY
XY
XY
XY
XY
XY
XY
XY
XY
XY
XY
XY
XY
XY
XY
XY
XY
od
tf
Fp
tF
od
XY
XY
XY
XY
XY
XY
XY
XY
XY
XY
XY
XY
XY
XY
XY
XY
XY
XY
XY
XY
XY
XY
FZ
"}
(46,1,1) = {"
FZ
FZ
FZ
FZ
FZ
FZ
FZ
FZ
FZ
FZ
FZ
FZ
FZ
FZ
FZ
FZ
FZ
FZ
Pa
Pa
Pa
Pa
Pa
FZ
FZ
FZ
FZ
FZ
FZ
FZ
FZ
FZ
FZ
FZ
FZ
FZ
FZ
FZ
FZ
FZ
FZ
FZ
FZ
FZ
FZ
FZ
"}
