"a" = (/obj/structure/bed/chair/dropship/pilot{dir = 1},/turf/open/floor/mainship/floor,/area/shuttle/minidropship)
"b" = (/obj/machinery/camera/autoname/mainship/dropship_two,/turf/open/floor/mainship/floor,/area/shuttle/minidropship)
"d" = (/obj/machinery/door/poddoor/shutters/transit/nonsmoothing,/turf/open/floor/plating/plating_catwalk,/area/shuttle/minidropship)
"e" = (/obj/machinery/light/floor{dir = 8},/turf/open/floor/plating/plating_catwalk,/area/shuttle/minidropship)
"g" = (/obj/machinery/computer/camera_advanced/shuttle_docker/minidropship,/turf/open/floor/mainship/mono,/area/shuttle/minidropship)
"h" = (/obj/machinery/light/floor{dir = 4},/turf/open/floor/plating/plating_catwalk,/area/shuttle/minidropship)
"l" = (/obj/structure/barricade/metal{dir = 8},/turf/open/floor/plating/plating_catwalk,/area/shuttle/minidropship)
"m" = (/obj/structure/table/mainship,/obj/item/storage/toolbox/electrical{pixel_y = 6},/obj/item/storage/toolbox/mechanical,/turf/open/floor/plating/plating_catwalk,/area/shuttle/minidropship)
"n" = (/obj/machinery/camera/autoname/mainship/dropship_two,/turf/open/floor/plating/plating_catwalk,/area/shuttle/minidropship)
"o" = (/obj/structure/window/framed/mainship/canterbury/dropship/reinforced,/turf/open/floor/plating/plating_catwalk,/area/shuttle/minidropship)
"p" = (/obj/structure/window/framed/mainship/canterbury/dropship/reinforced,/obj/machinery/door_control{dir = 4; id = "minidropship_podlock"; name = "inner door-control"; pixel_x = -25},/turf/open/floor/plating/plating_catwalk,/area/shuttle/minidropship)
"q" = (/obj/machinery/light{dir = 4},/turf/open/floor/plating/plating_catwalk,/area/shuttle/minidropship)
"s" = (/obj/structure/barricade/metal{dir = 4},/turf/open/floor/plating/plating_catwalk,/area/shuttle/minidropship)
"u" = (/obj/structure/bed/chair/dropship/passenger{dir = 1},/obj/docking_port/mobile/marine_dropship/minidropship,/turf/open/floor/plating/plating_catwalk,/area/shuttle/minidropship)
"v" = (/turf/open/floor/plating/plating_catwalk,/area/shuttle/minidropship)
"z" = (/obj/structure/barricade/metal{dir = 8},/obj/machinery/light{dir = 8},/turf/open/floor/plating/plating_catwalk,/area/shuttle/minidropship)
"A" = (/obj/machinery/door/airlock/mainship/command{dir = 1},/turf/open/floor/plating/plating_catwalk,/area/shuttle/minidropship)
"B" = (/obj/structure/dropship_piece/tadpole/engine{dir = 1; pixel_x = 23},/obj/structure/dropship_piece/tadpole/rearleft,/obj/structure/dropship_piece/two/weapon/rightright{dir = 1; pixel_y = 32},/turf/open/space/basic,/area/shuttle/minidropship)
"E" = (/turf/closed/shuttle/ert/engines/left{dir = 1},/area/shuttle/minidropship)
"F" = (/obj/machinery/door/poddoor/shutters/transit/nonsmoothing,/obj/machinery/door/poddoor/mainship/open/nonsmoothing{id = "minidropship_podlock"},/turf/open/floor/plating/plating_catwalk,/area/shuttle/minidropship)
"G" = (/obj/structure/barricade/metal{dir = 4},/obj/machinery/light{dir = 4},/turf/open/floor/plating/plating_catwalk,/area/shuttle/minidropship)
"I" = (/turf/closed/wall/mainship/outer/canterbury,/area/shuttle/minidropship)
"K" = (/obj/machinery/vending/nanomed/tadpolemed{dir = 4},/obj/structure/dropship_piece/tadpole/engine{dir = 1; pixel_x = -23},/turf/closed/wall/mainship/outer/canterbury,/area/shuttle/minidropship)
"L" = (/turf/closed/shuttle/ert/engines/right{dir = 1},/area/shuttle/minidropship)
"M" = (/obj/structure/dropship_piece/tadpole/engine{dir = 1; pixel_x = 23},/turf/closed/wall/mainship/outer/canterbury,/area/shuttle/minidropship)
"N" = (/obj/structure/closet/walllocker/hydrant/extinguisher{dir = 4},/turf/closed/wall/mainship/outer/canterbury,/area/shuttle/minidropship)
"O" = (/turf/open/floor/mainship/floor,/area/shuttle/minidropship)
"P" = (/obj/structure/bed/chair/dropship/passenger,/turf/open/floor/plating/plating_catwalk,/area/shuttle/minidropship)
"R" = (/obj/structure/dropship_piece/tadpole/rearright,/obj/structure/dropship_piece/tadpole/engine{dir = 1; pixel_x = -23},/obj/structure/dropship_piece/two/weapon/leftleft{dir = 1; pixel_y = 32},/turf/open/space/basic,/area/shuttle/minidropship)
"S" = (/obj/structure/bed/chair/dropship/passenger{dir = 1},/turf/open/floor/plating/plating_catwalk,/area/shuttle/minidropship)
"T" = (/obj/machinery/cic_maptable,/turf/open/floor/mainship/mono,/area/shuttle/minidropship)
"V" = (/obj/machinery/light{dir = 8},/turf/open/floor/plating/plating_catwalk,/area/shuttle/minidropship)
"W" = (/obj/structure/table/mainship,/turf/open/floor/plating/plating_catwalk,/area/shuttle/minidropship)
"X" = (/obj/machinery/door/poddoor/shutters/transit/nonsmoothing,/obj/machinery/door/poddoor/mainship/open/nonsmoothing{id = "minidropship_podlock"; dir = 1},/turf/open/floor/plating/plating_catwalk,/area/shuttle/minidropship)

(1,1,1) = {"
RXXXXXXB
FenvvnhF
FevvvvhF
FevvvvhF
KzPPPPGM
dlSSuSsd
IAIpoIAI
IVbgTbqI
NWOaaOmI
EIEIILIL
"}
