"a" = (/turf/closed/wall/mainship/outer/canterbury,/area/shuttle/minidropship)
"d" = (/obj/machinery/camera/autoname/mainship/dropship_two,/turf/open/floor/plating/plating_catwalk,/area/shuttle/minidropship)
"e" = (/turf/open/floor/plating/plating_catwalk,/area/shuttle/minidropship)
"f" = (/obj/structure/barricade/metal{dir = 4},/turf/open/floor/plating/plating_catwalk,/area/shuttle/minidropship)
"g" = (/obj/structure/barricade/metal{dir = 4},/obj/machinery/light{dir = 4},/turf/open/floor/plating/plating_catwalk,/area/shuttle/minidropship)
"j" = (/turf/open/floor/mainship/floor,/area/shuttle/minidropship)
"k" = (/obj/machinery/vending/nanomed/tadpolemed{dir = 4},/obj/structure/dropship_piece/tadpole/engine{dir = 1; pixel_x = -23},/turf/closed/wall/mainship/outer/canterbury,/area/shuttle/minidropship)
"l" = (/obj/structure/barricade/metal{dir = 8},/turf/open/floor/plating/plating_catwalk,/area/shuttle/minidropship)
"m" = (/obj/structure/bed/chair/dropship/passenger{dir = 1},/obj/docking_port/mobile/marine_dropship/minidropship,/turf/open/floor/plating/plating_catwalk,/area/shuttle/minidropship)
"n" = (/obj/structure/bed/chair/dropship/passenger{dir = 1},/turf/open/floor/plating/plating_catwalk,/area/shuttle/minidropship)
"p" = (/obj/structure/window/framed/mainship/canterbury/dropship/reinforced,/turf/open/floor/plating/plating_catwalk,/area/shuttle/minidropship)
"q" = (/obj/machinery/camera/autoname/mainship/dropship_two,/turf/open/floor/mainship/floor,/area/shuttle/minidropship)
"r" = (/obj/machinery/door/poddoor/shutters/transit/nonsmoothing,/obj/machinery/door/poddoor/mainship/open/nonsmoothing{id = "minidropship_podlock"; dir = 1},/turf/open/floor/plating/plating_catwalk,/area/shuttle/minidropship)
"s" = (/obj/structure/dropship_piece/tadpole/engine{dir = 1; pixel_x = 23},/obj/structure/dropship_piece/tadpole/rearleft,/obj/structure/dropship_piece/two/weapon/rightright{dir = 1; pixel_y = 32},/turf/open/space/basic,/area/shuttle/minidropship)
"u" = (/obj/machinery/door/poddoor/shutters/transit/nonsmoothing,/turf/open/floor/plating/plating_catwalk,/area/shuttle/minidropship)
"v" = (/obj/machinery/computer/camera_advanced/shuttle_docker/minidropship,/turf/open/floor/mainship/mono,/area/shuttle/minidropship)
"y" = (/obj/structure/dropship_piece/tadpole/engine{dir = 1; pixel_x = 23},/turf/closed/wall/mainship/outer/canterbury,/area/shuttle/minidropship)
"z" = (/obj/machinery/light/floor{dir = 8},/turf/open/floor/plating/plating_catwalk,/area/shuttle/minidropship)
"A" = (/turf/closed/shuttle/ert/engines/right{dir = 1},/area/shuttle/minidropship)
"C" = (/obj/structure/bed/chair/dropship/passenger,/turf/open/floor/plating/plating_catwalk,/area/shuttle/minidropship)
"D" = (/obj/machinery/cic_maptable,/turf/open/floor/mainship/mono,/area/shuttle/minidropship)
"F" = (/obj/structure/table/mainship,/obj/item/storage/toolbox/electrical{pixel_y = 6},/obj/item/storage/toolbox/mechanical,/turf/open/floor/plating/plating_catwalk,/area/shuttle/minidropship)
"G" = (/obj/structure/barricade/metal{dir = 8},/obj/machinery/light{dir = 8},/turf/open/floor/plating/plating_catwalk,/area/shuttle/minidropship)
"K" = (/obj/structure/closet/walllocker/hydrant/extinguisher{dir = 4},/turf/closed/wall/mainship/outer/canterbury,/area/shuttle/minidropship)
"L" = (/obj/machinery/light{dir = 4},/turf/open/floor/plating/plating_catwalk,/area/shuttle/minidropship)
"M" = (/obj/machinery/door/poddoor/shutters/transit/nonsmoothing,/obj/machinery/door/poddoor/mainship/open/nonsmoothing{id = "minidropship_podlock"},/turf/open/floor/plating/plating_catwalk,/area/shuttle/minidropship)
"N" = (/obj/machinery/door/airlock/mainship/command{dir = 1},/turf/open/floor/plating/plating_catwalk,/area/shuttle/minidropship)
"Q" = (/obj/structure/bed/chair/dropship/pilot{dir = 1},/turf/open/floor/mainship/floor,/area/shuttle/minidropship)
"R" = (/obj/structure/table/mainship,/turf/open/floor/plating/plating_catwalk,/area/shuttle/minidropship)
"S" = (/obj/machinery/light/floor{dir = 4},/turf/open/floor/plating/plating_catwalk,/area/shuttle/minidropship)
"T" = (/obj/structure/window/framed/mainship/canterbury/dropship/reinforced,/obj/machinery/door_control{dir = 4; id = "minidropship_podlock"; name = "inner door-control"; pixel_x = -25},/turf/open/floor/plating/plating_catwalk,/area/shuttle/minidropship)
"V" = (/obj/machinery/light{dir = 8},/turf/open/floor/plating/plating_catwalk,/area/shuttle/minidropship)
"W" = (/turf/closed/shuttle/ert/engines/left{dir = 1},/area/shuttle/minidropship)
"X" = (/obj/structure/dropship_piece/tadpole/rearright,/obj/structure/dropship_piece/tadpole/engine{dir = 1; pixel_x = -23},/obj/structure/dropship_piece/two/weapon/leftleft{dir = 1; pixel_y = 32},/turf/open/space/basic,/area/shuttle/minidropship)

(1,1,1) = {"
Xrrrrrrs
MzdeedSM
MzeeeeSM
MzeeeeSM
kGCCCCgy
ulnnmnfu
aNaTpaNa
aVqvDqLa
KRjQQjFa
WaWaaAaA
"}
