//MAP CONVERTED BY dmm2tgm.py THIS HEADER COMMENT PREVENTS RECONVERSION, DO NOT REMOVE
"a" = (
/obj/machinery/door/poddoor/shutters/transit/nonsmoothing,
/obj/machinery/door/poddoor/mainship/open{
	id = "minidropship_podlock"
	},
/obj/structure/barricade/folding{
	dir = 8
	},
/obj/machinery/light/floor{
	dir = 4
	},
/turf/open/floor/mainship/plate,
/area/shuttle/minidropship)
"b" = (
/obj/structure/dropship_piece/tadpole/rearleft{
	dir = 1
	},
/turf/template_noop,
/area/shuttle/minidropship)
"k" = (
/obj/machinery/door/poddoor/shutters/transit/nonsmoothing,
/obj/machinery/door/poddoor/mainship/open{
	id = "minidropship_podlock"
	},
/obj/structure/barricade/folding{
	dir = 4
	},
/obj/structure/closet/walllocker/hydrant/extinguisher{
	pixel_y = 0;
	pixel_x = -15
	},
/obj/machinery/light/floor{
	dir = 8
	},
/turf/open/floor/mainship/plate,
/area/shuttle/minidropship)
"m" = (
/obj/machinery/computer/camera_advanced/shuttle_docker/minidropship,
/turf/open/floor/mainship/plate/outline,
/area/shuttle/minidropship)
"o" = (
/obj/machinery/door/poddoor/shutters/transit/nonsmoothing,
/obj/machinery/door/poddoor/mainship/open{
	id = "minidropship_podlock"
	},
/obj/structure/barricade/folding{
	dir = 4
	},
/obj/machinery/light/floor{
	dir = 8
	},
/turf/open/floor/mainship/plate,
/area/shuttle/minidropship)
"q" = (
/obj/structure/dropship_piece/tadpole/rearright{
	dir = 1
	},
/obj/machinery/telecomms/relay/preset/telecomms/onboard,
/turf/template_noop,
/area/shuttle/minidropship)
"s" = (
/obj/structure/bed/chair/dropship/pilot,
/obj/machinery/door_control{
	id = "minidropship_podlock";
	name = "inner door-control";
	dir = 8
	},
/obj/machinery/camera/autoname/mainship/dropship_two,
/turf/open/floor/mainship/plate/outline,
/area/shuttle/minidropship)
"t" = (
/obj/structure/dropship_piece/tadpole/tadpole_nose/right{
	dir = 1;
	pixel_y = 32
	},
/obj/structure/dropship_piece/tadpole/cockpit/right{
	dir = 1
	},
/turf/open/floor/mainship/mono,
/area/shuttle/minidropship)
"v" = (
/obj/structure/dropship_piece/glasstwo/tadpole,
/obj/structure/dropship_piece/tadpole/engine{
	dir = 1;
	pixel_x = -23;
	pixel_y = -14
	},
/turf/open/floor/mainship/mono,
/area/shuttle/minidropship)
"x" = (
/obj/structure/dropship_piece/tadpole/tadpole_nose/left{
	dir = 1;
	pixel_y = 32
	},
/obj/structure/dropship_piece/tadpole/cockpit/left{
	dir = 1
	},
/turf/open/floor/mainship/mono,
/area/shuttle/minidropship)
"y" = (
/obj/machinery/door/poddoor/shutters/transit/nonsmoothing,
/obj/machinery/door/poddoor/mainship/open{
	id = "minidropship_podlock"
	},
/obj/structure/barricade/folding{
	dir = 4
	},
/turf/open/floor/mainship/plate,
/area/shuttle/minidropship)
"D" = (
/turf/open/floor/plating/plating_catwalk,
/area/shuttle/minidropship)
"E" = (
/obj/machinery/door/poddoor/shutters/transit/nonsmoothing,
/obj/machinery/door/poddoor/mainship/open{
	id = "minidropship_podlock"
	},
/obj/structure/barricade/folding{
	dir = 8
	},
/turf/open/floor/mainship/plate,
/area/shuttle/minidropship)
"G" = (
/turf/template_noop,
/area/shuttle/minidropship)
"I" = (
/obj/machinery/holopad,
/obj/docking_port/mobile/marine_dropship/minidropship,
/turf/open/floor/mainship/mono,
/area/shuttle/minidropship)
"L" = (
/obj/machinery/door/poddoor/shutters/transit/nonsmoothing{
	dir = 1
	},
/obj/machinery/door/poddoor/mainship/open{
	dir = 2;
	id = "minidropship_podlock"
	},
/obj/structure/barricade/folding,
/turf/open/floor/mainship/plate,
/area/shuttle/minidropship)
"M" = (
/turf/template_noop,
/area/space)
"R" = (
/obj/effect/attach_point/crew_weapon/minidropship,
/turf/open/floor/mainship/mono,
/area/shuttle/minidropship)
"S" = (
/obj/machinery/door/poddoor/mainship/open{
	id = "minidropship_podlock"
	},
/obj/machinery/door/poddoor/shutters/transit/nonsmoothing,
/obj/structure/barricade/folding{
	dir = 8
	},
/obj/machinery/vending/nanomed/tadpolemed{
	pixel_x = 8
	},
/obj/machinery/light/floor{
	dir = 4
	},
/turf/open/floor/mainship/plate,
/area/shuttle/minidropship)
"T" = (
/obj/structure/dropship_piece/tadpole/engine{
	dir = 1;
	pixel_x = 23;
	pixel_y = -14
	},
/obj/structure/dropship_piece/glassone/tadpole,
/turf/open/floor/mainship/mono,
/area/shuttle/minidropship)
"U" = (
/obj/structure/dropship_piece/glasstwo/tadpole{
	dir = 1
	},
/obj/structure/dropship_piece/tadpole/engine{
	dir = 1;
	pixel_x = -23;
	pixel_y = -14
	},
/turf/open/floor/mainship/mono,
/area/shuttle/minidropship)
"V" = (
/obj/structure/dropship_piece/tadpole/engine{
	dir = 1;
	pixel_x = 23;
	pixel_y = -14
	},
/obj/structure/dropship_piece/glassone/tadpole{
	dir = 1
	},
/turf/open/floor/mainship/mono,
/area/shuttle/minidropship)
"Y" = (
/obj/structure/dropship_piece/singlewindow/tadpole{
	dir = 1
	},
/obj/structure/dropship_piece/tadpole/tadpole_nose{
	dir = 1;
	pixel_y = 32
	},
/obj/structure/dropship_piece/two/weapon/leftleft{
	dir = 1;
	pixel_y = 32
	},
/obj/effect/attach_point/weapon/minidropship{
	equipment_offset_y = 25
	},
/turf/open/floor/mainship/mono,
/area/shuttle/minidropship)
"Z" = (
/obj/structure/dropship_piece/singlewindow/tadpole{
	dir = 1
	},
/obj/structure/dropship_piece/tadpole/tadpole_nose{
	dir = 1;
	pixel_y = 32
	},
/obj/structure/dropship_piece/two/weapon/rightright{
	dir = 1;
	pixel_y = 32
	},
/obj/effect/attach_point/weapon/minidropship{
	equipment_offset_y = 25
	},
/turf/open/floor/mainship/mono,
/area/shuttle/minidropship)

(1,1,1) = {"
M
M
M
M
M
M
M
M
M
"}
(2,1,1) = {"
M
M
x
v
S
E
a
U
b
"}
(3,1,1) = {"
M
G
Y
m
D
R
D
D
L
"}
(4,1,1) = {"
M
G
Z
s
D
I
D
D
L
"}
(5,1,1) = {"
M
M
t
T
k
y
o
V
q
"}
(6,1,1) = {"
M
M
M
M
M
M
M
M
M
"}
