//MAP CONVERTED BY dmm2tgm.py THIS HEADER COMMENT PREVENTS RECONVERSION, DO NOT REMOVE
"aa" = (
/turf/closed/wall/mainship/outer/canterbury,
/area/shuttle/minidropship)
"ab" = (
/obj/effect/turf_decal/warning_stripes/thick{
	dir = 8
	},
/obj/machinery/light/floor{
	dir = 8
	},
/turf/open/floor/plating/plating_catwalk,
/area/shuttle/minidropship)
"ac" = (
/turf/open/floor/plating/plating_catwalk,
/area/shuttle/minidropship)
"ag" = (
/obj/effect/turf_decal/warning_stripes/thick{
	dir = 4
	},
/obj/structure/closet/walllocker/hydrant/extinguisher{
	dir = 1
	},
/turf/open/floor/mainship/mono,
/area/shuttle/minidropship)
"ah" = (
/obj/docking_port/mobile/marine_dropship/minidropship,
/obj/effect/turf_decal/warning_stripes/thick{
	dir = 4
	},
/turf/open/floor/mainship/mono,
/area/shuttle/minidropship)
"ai" = (
/obj/machinery/door/poddoor/shutters/transit/nonsmoothing,
/obj/structure/window/framed/mainship/canterbury/dropship/reinforced,
/turf/open/floor/mainship/mono,
/area/shuttle/minidropship)
"aj" = (
/obj/structure/window/framed/mainship/canterbury/dropship/reinforced,
/obj/machinery/door/poddoor/shutters/transit/nonsmoothing,
/turf/open/floor/mainship/mono,
/area/shuttle/minidropship)
"ak" = (
/obj/effect/turf_decal/warning_stripes/thick{
	dir = 4
	},
/turf/open/floor/plating/plating_catwalk,
/area/shuttle/minidropship)
"am" = (
/obj/structure/dropship_piece/tadpole/tadpole_nose/right{
	dir = 1;
	pixel_y = 32
	},
/obj/effect/attach_point/weapon/minidropship{
	equipment_offset_y = 25
	},
/obj/structure/dropship_piece/two/weapon/rightright{
	dir = 1;
	pixel_y = 32
	},
/turf/closed/wall/mainship/outer/canterbury,
/area/shuttle/minidropship)
"an" = (
/obj/structure/window/framed/mainship/canterbury/dropship/reinforced,
/turf/open/floor/mainship/mono,
/area/shuttle/minidropship)
"ao" = (
/turf/closed/shuttle/ert/engines/left{
	dir = 1
	},
/area/shuttle/minidropship)
"ap" = (
/obj/machinery/camera/autoname/mainship/dropship_two{
	dir = 1
	},
/turf/open/floor/mainship/mono,
/area/shuttle/minidropship)
"as" = (
/obj/structure/window/reinforced/west,
/obj/machinery/cic_maptable,
/turf/open/floor/plating/plating_catwalk,
/area/shuttle/minidropship)
"au" = (
/obj/machinery/door/poddoor/shutters/transit/nonsmoothing,
/obj/machinery/door/poddoor/mainship/open{
	id = "minidropship_podlock"
	},
/turf/open/floor/plating/plating_catwalk,
/area/shuttle/minidropship)
"aw" = (
/obj/effect/attach_point/weapon/minidropship{
	equipment_offset_y = 25
	},
/obj/structure/dropship_piece/two/weapon/leftleft{
	dir = 1;
	pixel_y = 32
	},
/turf/closed/wall/mainship/outer/canterbury,
/area/shuttle/minidropship)
"aA" = (
/obj/structure/dropship_piece/tadpole/engine{
	dir = 1;
	pixel_x = -23
	},
/turf/closed/wall/mainship/outer/canterbury,
/area/shuttle/minidropship)
"aB" = (
/obj/effect/attach_point/crew_weapon/minidropship,
/turf/open/floor/plating/plating_catwalk,
/area/shuttle/minidropship)
"aC" = (
/obj/machinery/light/floor{
	dir = 4
	},
/turf/open/floor/mainship/mono,
/area/shuttle/minidropship)
"aF" = (
/obj/machinery/holopad,
/turf/open/floor/plating/plating_catwalk,
/area/shuttle/minidropship)
"aH" = (
/obj/structure/bed/chair/dropship/pilot{
	dir = 1
	},
/obj/machinery/door/window{
	dir = 2
	},
/turf/open/floor/plating/plating_catwalk,
/area/shuttle/minidropship)
"aK" = (
/obj/effect/turf_decal/warning_stripes/thick{
	dir = 1
	},
/turf/open/floor/mainship/mono,
/area/shuttle/minidropship)
"aL" = (
/obj/machinery/telecomms/relay/preset/telecomms/onboard,
/turf/closed/wall/mainship/outer/canterbury,
/area/shuttle/minidropship)
"aM" = (
/obj/machinery/vending/nanomed/tadpolemed{
	dir = 1
	},
/turf/open/floor/mainship/mono,
/area/shuttle/minidropship)
"aN" = (
/obj/effect/turf_decal/warning_stripes/thick{
	dir = 8
	},
/turf/open/floor/mainship/mono,
/area/shuttle/minidropship)
"aP" = (
/obj/machinery/door/poddoor/mainship/open{
	id = "minidropship_podlock"
	},
/obj/machinery/door/poddoor/shutters/transit/nonsmoothing,
/turf/open/floor/plating/plating_catwalk,
/area/shuttle/minidropship)
"aQ" = (
/turf/template_noop,
/area/template_noop)
"aU" = (
/obj/machinery/door/poddoor/shutters/transit/nonsmoothing{
	dir = 2
	},
/obj/machinery/door/poddoor/mainship/open{
	id = "minidropship_podlock";
	dir = 2
	},
/turf/open/floor/plating/plating_catwalk,
/area/shuttle/minidropship)
"aV" = (
/obj/structure/dropship_piece/tadpole/engine{
	dir = 1;
	pixel_x = 23
	},
/turf/closed/wall/mainship/outer/canterbury,
/area/shuttle/minidropship)
"aW" = (
/obj/effect/turf_decal/warning_stripes/thick/corner{
	dir = 4
	},
/turf/open/floor/mainship/mono,
/area/shuttle/minidropship)
"aY" = (
/turf/open/floor/mainship/mono,
/area/shuttle/minidropship)
"bJ" = (
/obj/structure/dropship_piece/tadpole/tadpole_nose{
	dir = 1;
	pixel_y = 32
	},
/turf/closed/wall/mainship/outer/canterbury,
/area/shuttle/minidropship)
"ip" = (
/obj/machinery/door/poddoor/shutters/transit/nonsmoothing{
	dir = 2
	},
/obj/machinery/door/poddoor/mainship/open{
	dir = 2;
	id = "minidropship_podlock"
	},
/turf/open/floor/plating/plating_catwalk,
/area/shuttle/minidropship)
"jt" = (
/obj/effect/turf_decal/warning_stripes/thick{
	dir = 1
	},
/obj/machinery/light/floor,
/turf/open/floor/plating/plating_catwalk,
/area/shuttle/minidropship)
"rN" = (
/obj/machinery/computer/camera_advanced/shuttle_docker/minidropship,
/obj/machinery/camera/autoname/mainship/dropship_two,
/obj/machinery/door_control{
	id = "minidropship_podlock";
	name = "inner door-control";
	dir = 8
	},
/turf/open/floor/plating/plating_catwalk,
/area/shuttle/minidropship)
"CK" = (
/obj/structure/dropship_piece/tadpole/engine{
	dir = 1;
	pixel_x = -23
	},
/obj/structure/window/framed/mainship/canterbury/dropship/reinforced,
/obj/machinery/door/poddoor/shutters/transit/nonsmoothing,
/turf/open/floor/mainship/mono,
/area/shuttle/minidropship)
"Kp" = (
/obj/effect/turf_decal/warning_stripes/thick/corner{
	dir = 8
	},
/obj/machinery/door_control{
	id = "minidropship_podlock";
	name = "inner door-control";
	dir = 8
	},
/turf/open/floor/mainship/mono,
/area/shuttle/minidropship)

(1,1,1) = {"
aw
aj
CK
aj
au
au
aP
aA
aQ
"}
(2,1,1) = {"
ip
aK
aY
aW
aN
ab
aN
aa
aa
"}
(3,1,1) = {"
ip
jt
ac
ac
ac
aB
ap
aa
ao
"}
(4,1,1) = {"
aU
aK
aY
Kp
ah
ak
ag
aa
aL
"}
(5,1,1) = {"
an
aa
as
aa
aF
aY
aM
aa
ao
"}
(6,1,1) = {"
aQ
bJ
rN
aH
aY
aC
aY
aa
aa
"}
(7,1,1) = {"
aQ
am
aV
aa
aj
aj
ai
aV
aQ
"}
