//MAP CONVERTED BY dmm2tgm.py THIS HEADER COMMENT PREVENTS RECONVERSION, DO NOT REMOVE
"a" = (
/obj/machinery/telecomms/relay/preset/telecomms/onboard,
/turf/closed/wall/mainship/outer/canterbury,
/area/shuttle/minidropship)
"b" = (
/obj/machinery/door/poddoor/shutters/transit/nonsmoothing,
/obj/machinery/door/poddoor/mainship/open/nonsmoothing{
	id = "minidropship_podlock"
	},
/obj/structure/barricade/folding{
	dir = 8
	},
/turf/open/floor/mainship/mono,
/area/shuttle/minidropship)
"d" = (
/obj/machinery/camera/autoname/mainship/dropship_two{
	dir = 8
	},
/obj/effect/turf_decal/tile/transparent/brown/half{
	dir = 4
	},
/turf/open/floor/mainship/mono,
/area/shuttle/minidropship)
"f" = (
/obj/structure/window/framed/mainship/canterbury/dropship/reinforced,
/obj/machinery/door/poddoor/mainship/open/nonsmoothing{
	id = "minidropship_podlock"
	},
/obj/machinery/door/poddoor/shutters/transit/nonsmoothing,
/turf/open/floor/mainship/mono,
/area/shuttle/minidropship)
"i" = (
/turf/closed/wall/mainship/outer/canterbury,
/area/shuttle/minidropship)
"k" = (
/obj/structure/window/framed/mainship/canterbury/dropship/reinforced,
/obj/machinery/door/poddoor/mainship/open/nonsmoothing{
	id = "minidropship_podlock";
	dir = 1
	},
/turf/open/floor/mainship/mono,
/area/shuttle/minidropship)
"o" = (
/obj/machinery/door/poddoor/shutters/transit/nonsmoothing,
/obj/machinery/door/poddoor/mainship/open/nonsmoothing{
	id = "minidropship_podlock"
	},
/obj/structure/barricade/folding{
	dir = 4
	},
/turf/open/floor/mainship/mono,
/area/shuttle/minidropship)
"q" = (
/obj/item/supply_beacon,
/turf/open/floor/plating/plating_catwalk,
/area/shuttle/minidropship)
"r" = (
/obj/structure/dropship_piece/two/wing/left/top,
/turf/template_noop,
/area/space)
"s" = (
/obj/effect/turf_decal/tile/transparent/brown/half,
/turf/open/floor/mainship/mono,
/area/shuttle/minidropship)
"t" = (
/obj/structure/dropship_piece/tadpole/engine{
	dir = 1;
	pixel_x = -23
	},
/turf/closed/wall/mainship/outer/canterbury,
/area/shuttle/minidropship)
"u" = (
/obj/effect/turf_decal/tile/transparent/brown/anticorner{
	dir = 4
	},
/turf/open/floor/mainship/mono,
/area/shuttle/minidropship)
"v" = (
/obj/structure/window/reinforced,
/obj/effect/turf_decal/tile/transparent/dark_blue/anticorner,
/obj/machinery/vending/nanomed/tadpolemed{
	pixel_x = 5;
	dir = 8
	},
/turf/open/floor/mainship/mono,
/area/shuttle/minidropship)
"w" = (
/obj/effect/turf_decal/tile/transparent/brown/anticorner{
	dir = 1
	},
/turf/open/floor/mainship/mono,
/area/shuttle/minidropship)
"y" = (
/obj/structure/dropship_piece/two/wing/right/top,
/turf/template_noop,
/area/shuttle/minidropship)
"z" = (
/turf/open/floor/plating/plating_catwalk,
/area/shuttle/minidropship)
"B" = (
/obj/machinery/light{
	dir = 4
	},
/obj/effect/turf_decal/tile/transparent/brown/anticorner,
/turf/open/floor/mainship/mono,
/area/shuttle/minidropship)
"C" = (
/obj/machinery/door/window{
	dir = 2
	},
/obj/structure/bed/chair/dropship/pilot{
	dir = 1
	},
/turf/open/floor/plating/plating_catwalk,
/area/shuttle/minidropship)
"F" = (
/obj/docking_port/mobile/marine_dropship/minidropship,
/turf/open/floor/plating/plating_catwalk,
/area/shuttle/minidropship)
"G" = (
/obj/effect/turf_decal/tile/transparent/brown/half{
	dir = 8
	},
/turf/open/floor/mainship/mono,
/area/shuttle/minidropship)
"H" = (
/obj/structure/dropship_piece/two/wing/right/top,
/turf/template_noop,
/area/space)
"J" = (
/obj/machinery/door_control{
	dir = 4;
	id = "minidropship_podlock";
	name = "inner door-control";
	pixel_x = -25
	},
/obj/effect/turf_decal/tile/transparent/brown/half{
	dir = 8
	},
/turf/open/floor/mainship/mono,
/area/shuttle/minidropship)
"L" = (
/obj/machinery/computer/ordercomp,
/turf/open/floor/plating/plating_catwalk,
/area/shuttle/minidropship)
"N" = (
/obj/effect/attach_point/crew_weapon/minidropship,
/turf/open/floor/plating/plating_catwalk,
/area/shuttle/minidropship)
"O" = (
/turf/template_noop,
/area/space)
"P" = (
/obj/machinery/light{
	dir = 4
	},
/obj/effect/turf_decal/tile/transparent/dark_blue/anticorner{
	dir = 4
	},
/obj/machinery/cic_maptable,
/turf/open/floor/mainship/mono,
/area/shuttle/minidropship)
"R" = (
/obj/effect/turf_decal/tile/transparent/brown/half{
	dir = 4
	},
/turf/open/floor/mainship/mono,
/area/shuttle/minidropship)
"S" = (
/obj/machinery/light{
	dir = 8
	},
/obj/effect/turf_decal/tile/transparent/brown/anticorner{
	dir = 8
	},
/turf/open/floor/mainship/mono,
/area/shuttle/minidropship)
"T" = (
/obj/structure/window/framed/mainship/canterbury/dropship/reinforced,
/obj/machinery/door/poddoor/shutters/transit/nonsmoothing,
/obj/machinery/door/poddoor/mainship/open/nonsmoothing{
	id = "minidropship_podlock"
	},
/turf/open/floor/mainship/mono,
/area/shuttle/minidropship)
"U" = (
/obj/structure/dropship_piece/two/wing/left/top,
/turf/template_noop,
/area/shuttle/minidropship)
"V" = (
/obj/structure/window/reinforced,
/obj/effect/turf_decal/tile/transparent/dark_blue/anticorner{
	dir = 8
	},
/obj/structure/closet/walllocker/hydrant/extinguisher{
	dir = 4
	},
/turf/open/floor/mainship/mono,
/area/shuttle/minidropship)
"W" = (
/turf/closed/shuttle/ert/engines/left{
	dir = 1
	},
/area/shuttle/minidropship)
"X" = (
/obj/machinery/computer/camera_advanced/shuttle_docker/minidropship,
/obj/effect/turf_decal/tile/transparent/dark_blue/half{
	dir = 1
	},
/turf/open/floor/mainship/mono,
/area/shuttle/minidropship)
"Y" = (
/obj/machinery/light{
	dir = 8
	},
/obj/structure/table/mainship,
/obj/effect/turf_decal/tile/transparent/dark_blue/anticorner{
	dir = 1
	},
/obj/item/stack/barbed_wire/small_stack,
/turf/open/floor/mainship/mono,
/area/shuttle/minidropship)
"Z" = (
/obj/structure/dropship_piece/tadpole/engine{
	dir = 1;
	pixel_x = 23
	},
/turf/closed/wall/mainship/outer/canterbury,
/area/shuttle/minidropship)

(1,1,1) = {"
U
t
i
O
O
O
r
i
t
W
"}
(2,1,1) = {"
i
i
i
T
b
b
f
i
a
i
"}
(3,1,1) = {"
k
Y
V
w
G
G
G
J
S
k
"}
(4,1,1) = {"
k
X
C
z
N
F
q
L
s
k
"}
(5,1,1) = {"
k
P
v
u
R
R
R
d
B
k
"}
(6,1,1) = {"
i
i
i
T
o
o
T
i
i
i
"}
(7,1,1) = {"
y
Z
i
O
O
O
H
i
Z
W
"}
