//MAP CONVERTED BY dmm2tgm.py THIS HEADER COMMENT PREVENTS RECONVERSION, DO NOT REMOVE
"aa" = (
/turf/template_noop,
/area/template_noop)
"ab" = (
/turf/closed/wall/mainship/outer/canterbury,
/area/shuttle/canterbury/cic)
"ac" = (
/obj/structure/window/framed/mainship/hull/canterbury,
/turf/open/floor/plating,
/area/shuttle/canterbury/cic)
"ad" = (
/obj/structure/table/mainship,
/obj/machinery/computer/security/marine_network,
/turf/open/floor/mainship/blue{
	dir = 9
	},
/area/shuttle/canterbury/cic)
"ae" = (
/obj/structure/table/mainship,
/obj/machinery/computer/shuttle/shuttle_control/canterbury,
/turf/open/floor/mainship/blue{
	dir = 1
	},
/area/shuttle/canterbury/cic)
"af" = (
/obj/structure/table/mainship,
/obj/machinery/computer/camera_advanced/overwatch,
/turf/open/floor/mainship/blue{
	dir = 1
	},
/area/shuttle/canterbury/cic)
"ag" = (
/obj/machinery/computer/supplycomp/crash,
/turf/open/floor/mainship/blue{
	dir = 1
	},
/area/shuttle/canterbury/cic)
"ah" = (
/obj/structure/table/mainship,
/obj/machinery/computer/marine_card,
/turf/open/floor/mainship/blue{
	dir = 5
	},
/area/shuttle/canterbury/cic)
"ai" = (
/turf/open/floor/mainship/blue{
	dir = 8
	},
/area/shuttle/canterbury/cic)
"aj" = (
/obj/structure/bed/chair/dropship/pilot{
	dir = 1
	},
/obj/effect/landmark/start/job/crash/fieldcommander,
/turf/open/floor/mainship/mono,
/area/shuttle/canterbury/cic)
"ak" = (
/turf/open/floor/mainship/blue/full,
/area/shuttle/canterbury/cic)
"am" = (
/turf/open/floor/mainship/blue{
	dir = 4
	},
/area/shuttle/canterbury/cic)
"an" = (
/turf/closed/wall/mainship/outer/canterbury,
/area/shuttle/canterbury)
"ao" = (
/obj/structure/cable,
/obj/docking_port/mobile/crashmode,
/turf/open/floor/plating/plating_catwalk,
/area/shuttle/canterbury)
"ap" = (
/obj/machinery/light{
	dir = 8
	},
/obj/structure/closet/secure_closet/guncabinet/canterbury,
/obj/machinery/firealarm{
	dir = 1
	},
/obj/item/radio/intercom{
	dir = 4;
	freerange = 1;
	name = "General Listening Channel";
	pixel_y = -28
	},
/turf/open/floor/mainship/blue{
	dir = 10
	},
/area/shuttle/canterbury/cic)
"aq" = (
/obj/machinery/air_alarm{
	dir = 1
	},
/obj/machinery/telecomms/allinone/needs_power,
/turf/open/floor/mainship/blue,
/area/shuttle/canterbury/cic)
"ar" = (
/obj/structure/cable,
/turf/open/floor/mainship,
/area/shuttle/canterbury/cic)
"as" = (
/obj/machinery/power/apc/mainship{
	dir = 1
	},
/obj/structure/cable,
/obj/machinery/marine_selector/clothes/commander,
/turf/open/floor/mainship/blue,
/area/shuttle/canterbury/cic)
"at" = (
/obj/machinery/light{
	dir = 4
	},
/obj/machinery/marine_selector/gear/commander,
/turf/open/floor/mainship/blue{
	dir = 6
	},
/area/shuttle/canterbury/cic)
"au" = (
/obj/machinery/air_alarm,
/obj/machinery/door_control{
	dir = 4;
	id = "port_umbilical_outer";
	name = "outer door-control"
	},
/obj/structure/largecrate/supply/supplies/sandbags,
/turf/open/floor/mainship/cargo,
/area/shuttle/canterbury)
"av" = (
/obj/structure/rack,
/obj/effect/turf_decal/warning_stripes/thin{
	dir = 4
	},
/obj/item/tool/hand_labeler,
/obj/item/storage/toolbox/electrical,
/obj/machinery/light/small{
	dir = 1
	},
/obj/item/stack/barbed_wire/full,
/obj/item/stack/razorwire/full,
/obj/item/stack/sheet/metal/large_stack,
/obj/item/stack/sheet/metal/large_stack,
/obj/item/stack/sheet/plasteel/medium_stack,
/obj/item/tool/wrench,
/obj/item/storage/toolbox/mechanical,
/obj/item/tool/screwdriver,
/obj/item/ammo_magazine/hsg102/hsg_nest,
/obj/item/ammo_magazine/hsg102/hsg_nest,
/obj/item/ammo_magazine/hsg102/hsg_nest,
/turf/open/floor/mainship/cargo,
/area/shuttle/canterbury)
"aw" = (
/obj/machinery/door/airlock/mainship/command/canterbury{
	dir = 1;
	name = "\improper Command Cockpit"
	},
/obj/structure/cable,
/turf/open/floor/mainship/mono,
/area/shuttle/canterbury/cic)
"ax" = (
/obj/machinery/light/small{
	dir = 1
	},
/obj/structure/cable,
/obj/machinery/mech_bay_recharge_port,
/turf/open/floor/mainship/cargo,
/area/shuttle/canterbury)
"ay" = (
/obj/machinery/air_alarm,
/obj/machinery/door_control{
	dir = 8;
	id = "starboard_umbilical_outer";
	name = "outer door-control"
	},
/obj/vehicle/ridden/powerloader,
/turf/open/floor/mainship/cargo,
/area/shuttle/canterbury)
"aA" = (
/obj/machinery/door_control{
	dir = 8;
	id = "aft_engine_podlock"
	},
/turf/open/floor/mainship/mono,
/area/shuttle/canterbury)
"aB" = (
/obj/structure/bed/chair/dropship/passenger,
/obj/effect/landmark/start/job/crash/squadrobot,
/turf/open/floor/mainship/mono,
/area/shuttle/canterbury)
"aC" = (
/obj/machinery/computer/body_scanconsole,
/turf/open/floor/mainship/sterile,
/area/shuttle/canterbury/medical)
"aD" = (
/turf/open/floor/mainship/mono,
/area/shuttle/canterbury)
"aF" = (
/turf/open/floor/mainship/stripesquare,
/area/shuttle/canterbury)
"aH" = (
/obj/machinery/door/poddoor/mainship{
	id = "port_umbilical_outer";
	name = "\improper Umbillical Airlock"
	},
/obj/machinery/door/poddoor/shutters/transit,
/turf/open/floor/mainship/mono,
/area/shuttle/canterbury)
"aJ" = (
/turf/open/floor/plating/plating_catwalk,
/area/shuttle/canterbury)
"aK" = (
/obj/machinery/door/poddoor/mainship{
	id = "starboard_umbilical_outer";
	name = "\improper Umbillical Airlock"
	},
/obj/machinery/door/poddoor/shutters/transit,
/turf/open/floor/mainship/mono,
/area/shuttle/canterbury)
"aL" = (
/obj/effect/landmark/start/job/crash/squadmarine,
/obj/structure/bed/chair/dropship/passenger{
	dir = 1
	},
/turf/open/floor/mainship/mono,
/area/shuttle/canterbury)
"aN" = (
/obj/structure/dropship_equipment/shuttle/weapon_holder/machinegun,
/turf/open/floor/mainship/cargo,
/area/shuttle/canterbury)
"aO" = (
/obj/structure/cable,
/obj/structure/barricade/plasteel{
	dir = 4
	},
/turf/open/floor/plating/plating_catwalk,
/area/shuttle/canterbury)
"aP" = (
/obj/machinery/power/fusion_engine/random,
/obj/structure/cable,
/turf/open/floor/mainship/mono,
/area/shuttle/canterbury)
"aQ" = (
/obj/machinery/fuelcell_recycler,
/obj/machinery/light{
	dir = 1
	},
/turf/open/floor/mainship/mono,
/area/shuttle/canterbury)
"aR" = (
/obj/structure/window/framed/mainship/canterbury,
/turf/open/floor/plating,
/area/shuttle/canterbury)
"aT" = (
/obj/structure/reagent_dispensers/fueltank,
/turf/open/floor/mainship/orange/full,
/area/shuttle/canterbury)
"aV" = (
/obj/effect/landmark/start/job/crash/squadleader,
/turf/open/floor/mainship/mono,
/area/shuttle/canterbury)
"aW" = (
/obj/machinery/marine_selector/clothes/leader,
/turf/open/floor/mainship/cargo,
/area/shuttle/canterbury)
"aZ" = (
/obj/effect/turf_decal/warning_stripes/thin{
	dir = 1
	},
/obj/effect/turf_decal/warning_stripes/thin{
	dir = 4
	},
/obj/structure/cable,
/turf/open/floor/mainship/tcomms,
/area/shuttle/canterbury)
"bb" = (
/obj/machinery/door/airlock/mainship/engineering/free_access,
/obj/structure/cable,
/turf/open/floor/mainship/mono,
/area/shuttle/canterbury)
"bd" = (
/obj/machinery/vending/weapon/crash,
/turf/open/floor/mainship/cargo,
/area/shuttle/canterbury)
"be" = (
/turf/open/floor/mainship,
/area/shuttle/canterbury)
"bg" = (
/obj/structure/cable,
/obj/effect/landmark/start/job/crash/synthetic,
/turf/open/floor/mainship/orange/full,
/area/shuttle/canterbury)
"bi" = (
/obj/machinery/power/smes/preset,
/obj/effect/turf_decal/warning_stripes/thin{
	dir = 4
	},
/obj/structure/cable,
/turf/open/floor/mainship/tcomms,
/area/shuttle/canterbury)
"bj" = (
/obj/machinery/power/monitor{
	name = "Core Power Monitoring"
	},
/obj/structure/cable,
/obj/machinery/light,
/turf/open/floor/mainship,
/area/shuttle/canterbury)
"bk" = (
/obj/machinery/marine_selector/gear/leader,
/turf/open/floor/mainship/cargo,
/area/shuttle/canterbury)
"bl" = (
/obj/item/lightreplacer,
/obj/item/clothing/glasses/welding,
/obj/item/cell/high,
/obj/machinery/cell_charger,
/obj/item/radio,
/obj/item/tool/crowbar,
/obj/structure/table/reinforced,
/obj/item/storage/box/crate/sentry,
/obj/item/storage/box/crate/sentry,
/obj/item/storage/box/crate/sentry,
/obj/machinery/light,
/turf/open/floor/mainship/mono,
/area/shuttle/canterbury)
"bn" = (
/obj/structure/window/framed/mainship/canterbury,
/obj/structure/cable,
/turf/open/floor/mainship/orange/full,
/area/shuttle/canterbury)
"bo" = (
/turf/closed/wall/mainship/outer/canterbury,
/area/shuttle/canterbury/medical)
"bp" = (
/obj/effect/landmark/start/latejoin/crash,
/obj/machinery/light{
	dir = 1
	},
/turf/open/floor/mainship/mono,
/area/shuttle/canterbury)
"bq" = (
/obj/effect/landmark/start/latejoin/crash,
/turf/open/floor/mainship/mono,
/area/shuttle/canterbury)
"br" = (
/obj/machinery/vending/weapon/crash,
/turf/open/floor/mainship/mono,
/area/shuttle/canterbury)
"bt" = (
/obj/machinery/loadout_vendor/crash,
/turf/open/floor/mainship/mono,
/area/shuttle/canterbury)
"bu" = (
/obj/machinery/marine_selector/clothes/medic,
/obj/machinery/light{
	dir = 8
	},
/turf/open/floor/mainship/red,
/area/shuttle/canterbury)
"bv" = (
/obj/effect/landmark/start/job/crash/squadcorpsman,
/obj/machinery/light,
/turf/open/floor/mainship/red/full,
/area/shuttle/canterbury)
"bw" = (
/obj/machinery/bodyscanner,
/obj/machinery/air_alarm{
	dir = 4
	},
/turf/open/floor/mainship/sterile,
/area/shuttle/canterbury/medical)
"by" = (
/obj/machinery/light{
	dir = 1
	},
/obj/machinery/robotic_cradle,
/turf/open/floor/mainship/sterile,
/area/shuttle/canterbury/medical)
"bz" = (
/obj/effect/landmark/start/job/crash/squadengineer,
/turf/open/floor/mainship/red/full,
/area/shuttle/canterbury)
"bA" = (
/obj/machinery/atmospherics/components/unary/cryo_cell,
/turf/open/floor/mainship/sterile,
/area/shuttle/canterbury/medical)
"bB" = (
/obj/machinery/marine_selector/clothes/engi,
/obj/machinery/light{
	dir = 8
	},
/turf/open/floor/mainship/red/full,
/area/shuttle/canterbury)
"bC" = (
/obj/item/fuel_cell/full,
/obj/item/fuel_cell/random,
/obj/item/fuel_cell/random,
/turf/open/floor/mainship/mono,
/area/shuttle/canterbury)
"bD" = (
/obj/effect/landmark/start/job/crash/squadsmartgunner,
/turf/open/floor/mainship/red,
/area/shuttle/canterbury)
"bE" = (
/turf/open/floor/mainship/tcomms,
/area/shuttle/canterbury)
"bF" = (
/obj/machinery/marine_selector/clothes/smartgun,
/obj/machinery/light,
/turf/open/floor/mainship/red/full,
/area/shuttle/canterbury)
"bG" = (
/obj/structure/barricade/plasteel{
	dir = 8
	},
/turf/open/floor/plating/plating_catwalk,
/area/shuttle/canterbury)
"bH" = (
/obj/machinery/computer/autodoc_console,
/turf/open/floor/mainship/sterile,
/area/shuttle/canterbury/medical)
"bI" = (
/turf/open/floor/mainship/sterile,
/area/shuttle/canterbury/medical)
"bJ" = (
/obj/machinery/vending/armor_supply,
/obj/machinery/light,
/turf/open/floor/mainship,
/area/shuttle/canterbury)
"bK" = (
/obj/structure/window/framed/mainship/white/canterbury,
/turf/open/floor/plating,
/area/shuttle/canterbury/medical)
"bO" = (
/obj/structure/cable,
/turf/open/floor/plating/plating_catwalk,
/area/shuttle/canterbury)
"bQ" = (
/obj/machinery/computer/cryopod{
	dir = 8
	},
/turf/open/floor/mainship/mono,
/area/shuttle/canterbury)
"bR" = (
/obj/machinery/bioprinter/stocked,
/turf/open/floor/mainship/sterile/dark,
/area/shuttle/canterbury/medical)
"bS" = (
/obj/machinery/chem_master,
/turf/open/floor/mainship/sterile/dark,
/area/shuttle/canterbury/medical)
"bT" = (
/obj/machinery/power/apc/mainship{
	dir = 1
	},
/obj/structure/cable,
/obj/effect/landmark/start/job/crash/medicalofficer,
/turf/open/floor/mainship/sterile,
/area/shuttle/canterbury/medical)
"bU" = (
/obj/machinery/vending/MarineMed/Blood,
/turf/open/floor/mainship/sterile/dark,
/area/shuttle/canterbury/medical)
"bV" = (
/obj/structure/bed/chair/dropship/passenger{
	dir = 4
	},
/obj/effect/landmark/start/job/crash/squadmarine,
/turf/open/floor/mainship/mono,
/area/shuttle/canterbury)
"bW" = (
/obj/effect/landmark/start/job/crash/squadmarine,
/obj/structure/barricade/plasteel,
/turf/open/floor/mainship/mono,
/area/shuttle/canterbury)
"bZ" = (
/obj/machinery/optable,
/obj/item/tank/anesthetic,
/obj/item/clothing/mask/breath/medical,
/turf/open/floor/mainship/sterile/dark,
/area/shuttle/canterbury/medical)
"ca" = (
/obj/effect/landmark/start/job/crash/cmo,
/turf/open/floor/mainship/sterile/dark,
/area/shuttle/canterbury/medical)
"cb" = (
/obj/machinery/vending/medical,
/turf/open/floor/mainship/sterile/dark,
/area/shuttle/canterbury/medical)
"cc" = (
/obj/structure/bed/chair/dropship/passenger{
	dir = 8
	},
/turf/open/floor/mainship/mono,
/area/shuttle/canterbury)
"cd" = (
/obj/machinery/loadout_vendor,
/turf/open/floor/mainship/red/full,
/area/shuttle/canterbury)
"ce" = (
/obj/structure/table/reinforced,
/obj/item/storage/surgical_tray,
/obj/item/storage/firstaid/adv,
/obj/structure/sink{
	dir = 1
	},
/obj/item/reagent_containers/glass/beaker/bluespace,
/obj/item/reagent_containers/glass/beaker/bluespace,
/turf/open/floor/mainship/sterile/dark,
/area/shuttle/canterbury/medical)
"cf" = (
/obj/machinery/chem_dispenser,
/obj/machinery/light,
/turf/open/floor/mainship/sterile/dark,
/area/shuttle/canterbury/medical)
"cg" = (
/obj/machinery/vending/MarineMed,
/turf/open/floor/mainship/sterile,
/area/shuttle/canterbury/medical)
"ci" = (
/obj/structure/bed/chair/dropship/passenger,
/obj/effect/landmark/start/job/crash/squadsmartgunner,
/obj/structure/cable,
/turf/open/floor/plating/plating_catwalk,
/area/shuttle/canterbury)
"ck" = (
/obj/structure/bed/chair/dropship/passenger{
	dir = 4
	},
/obj/effect/landmark/start/job/crash/squadspecialist,
/turf/open/floor/mainship/mono,
/area/shuttle/canterbury)
"cl" = (
/obj/structure/shuttle/engine/propulsion/burst/left,
/turf/open/floor/podhatch/floor,
/area/shuttle/canterbury)
"cm" = (
/obj/structure/shuttle/engine/propulsion,
/turf/open/floor/podhatch/floor,
/area/shuttle/canterbury)
"cn" = (
/obj/structure/shuttle/engine/propulsion/burst/right,
/turf/open/floor/podhatch/floor,
/area/shuttle/canterbury)
"co" = (
/obj/machinery/door/poddoor/mainship{
	dir = 1;
	id = "aft_engine_podlock"
	},
/obj/machinery/door/poddoor/shutters/transit{
	dir = 2
	},
/turf/open/floor/plating,
/area/shuttle/canterbury)
"cp" = (
/obj/structure/bed/chair/dropship/passenger{
	dir = 4
	},
/turf/open/floor/mainship/mono,
/area/shuttle/canterbury)
"cs" = (
/obj/machinery/door/airlock/mainship/medical/glass/free_access{
	dir = 2
	},
/turf/open/floor/mainship/sterile/dark,
/area/shuttle/canterbury/medical)
"cv" = (
/obj/structure/cable,
/obj/effect/landmark/start/job/crash/squadrobot,
/turf/open/floor/mainship/orange/full,
/area/shuttle/canterbury)
"cw" = (
/obj/structure/table/reinforced,
/obj/machinery/recharger,
/obj/item/defibrillator,
/obj/item/storage/firstaid/adv,
/obj/item/storage/firstaid/fire,
/obj/item/storage/firstaid/regular,
/obj/item/storage/firstaid/o2,
/obj/item/storage/box/bodybags,
/obj/item/roller,
/obj/item/roller,
/obj/machinery/firealarm,
/obj/item/reagent_containers/spray/cleaner,
/obj/item/reagent_containers/glass/beaker/cryomix,
/obj/machinery/vending/nanomed,
/turf/open/floor/mainship/sterile/dark,
/area/shuttle/canterbury/medical)
"cy" = (
/obj/structure/table/reinforced,
/obj/machinery/reagentgrinder{
	pixel_x = -1;
	pixel_y = 8
	},
/turf/open/floor/mainship/sterile/dark,
/area/shuttle/canterbury/medical)
"cz" = (
/obj/machinery/light{
	dir = 1
	},
/turf/open/floor/mainship/red/full,
/area/shuttle/canterbury)
"cA" = (
/obj/machinery/vending/armor_supply,
/turf/open/floor/mainship/red/full,
/area/shuttle/canterbury)
"cE" = (
/obj/machinery/marine_selector/gear/smartgun,
/turf/open/floor/mainship/red/full,
/area/shuttle/canterbury)
"cF" = (
/obj/structure/bed/chair/dropship/passenger,
/obj/effect/landmark/start/job/crash/squadcorpsman,
/turf/open/floor/mainship/mono,
/area/shuttle/canterbury)
"cH" = (
/obj/machinery/light{
	dir = 1
	},
/obj/machinery/marine_selector/gear/marine,
/turf/open/floor/mainship/mono,
/area/shuttle/canterbury)
"cI" = (
/turf/closed/wall/mainship/white/canterbury,
/area/shuttle/canterbury/medical)
"cJ" = (
/turf/open/floor/mainship/sterile/dark,
/area/shuttle/canterbury/medical)
"cK" = (
/obj/machinery/marine_selector/clothes,
/turf/open/floor/mainship/red/full,
/area/shuttle/canterbury)
"cN" = (
/obj/machinery/vending/nanomed,
/turf/open/floor/mainship/mono,
/area/shuttle/canterbury)
"cO" = (
/obj/machinery/marine_selector/gear/engi,
/turf/open/floor/mainship/red/full,
/area/shuttle/canterbury)
"cP" = (
/obj/structure/bed/chair/dropship/passenger,
/obj/effect/landmark/start/job/crash/squadengineer,
/turf/open/floor/mainship/mono,
/area/shuttle/canterbury)
"cQ" = (
/obj/structure/barricade/plasteel{
	dir = 4
	},
/turf/open/floor/mainship/mono,
/area/shuttle/canterbury)
"cR" = (
/obj/structure/bed/chair/dropship/passenger{
	dir = 1
	},
/obj/effect/landmark/start/job/crash/squadcorpsman,
/turf/open/floor/mainship/mono,
/area/shuttle/canterbury)
"cS" = (
/obj/structure/bed/chair/dropship/passenger{
	dir = 1
	},
/obj/effect/landmark/start/job/crash/squadengineer,
/turf/open/floor/mainship/mono,
/area/shuttle/canterbury)
"cT" = (
/obj/machinery/light/small,
/obj/structure/barricade/plasteel{
	dir = 4
	},
/turf/open/floor/mainship/mono,
/area/shuttle/canterbury)
"cU" = (
/obj/structure/bed/chair/dropship/passenger{
	dir = 1
	},
/obj/effect/landmark/start/job/crash/squadspecialist,
/turf/open/floor/mainship/mono,
/area/shuttle/canterbury)
"cV" = (
/obj/structure/barricade/plasteel{
	dir = 8
	},
/turf/open/floor/mainship/mono,
/area/shuttle/canterbury)
"cW" = (
/obj/item/radio/intercom{
	dir = 1;
	freerange = 1;
	name = "General Listening Channel";
	pixel_y = -28
	},
/turf/open/floor/mainship/stripesquare,
/area/shuttle/canterbury)
"cY" = (
/turf/open/floor/mainship/cargo,
/area/shuttle/canterbury)
"cZ" = (
/obj/structure/barricade/plasteel,
/turf/open/floor/mainship/mono,
/area/shuttle/canterbury)
"da" = (
/obj/effect/landmark/start/job/crash/squadrobot,
/obj/structure/barricade/plasteel,
/turf/open/floor/mainship/mono,
/area/shuttle/canterbury)
"db" = (
/obj/structure/cable,
/turf/open/floor/mainship/mono,
/area/shuttle/canterbury)
"dM" = (
/obj/effect/landmark/start/job/crash/squadmarine,
/turf/open/floor/mainship/red{
	dir = 4
	},
/area/shuttle/canterbury)
"ex" = (
/obj/machinery/light/small{
	dir = 4
	},
/obj/machinery/air_alarm{
	dir = 8
	},
/turf/open/floor/mainship/cargo,
/area/shuttle/canterbury)
"fq" = (
/turf/open/floor/mainship/orange/full,
/area/shuttle/canterbury)
"ka" = (
/obj/machinery/light,
/obj/machinery/shower,
/turf/open/floor/mainship/sterile,
/area/shuttle/canterbury/medical)
"lC" = (
/obj/machinery/light/small{
	dir = 8
	},
/turf/open/floor/mainship/cargo,
/area/shuttle/canterbury)
"lG" = (
/turf/open/floor/mainship/blue,
/area/shuttle/canterbury/cic)
"lL" = (
/obj/structure/cable,
/obj/effect/landmark/start/job/crash/squadmarine,
/turf/open/floor/plating/plating_catwalk,
/area/shuttle/canterbury)
"pU" = (
/obj/machinery/cryopod,
/turf/open/floor/mainship/mono,
/area/shuttle/canterbury)
"pY" = (
/obj/machinery/door/airlock/mainship/marine/canterbury{
	dir = 8
	},
/turf/open/floor/mainship/mono,
/area/shuttle/canterbury)
"rF" = (
/obj/machinery/marine_selector/gear/medic,
/turf/open/floor/mainship/red/full,
/area/shuttle/canterbury)
"sm" = (
/obj/structure/cable,
/obj/effect/landmark/start/job/crash/squadmarine,
/turf/open/floor/mainship/mono,
/area/shuttle/canterbury)
"sJ" = (
/obj/structure/cable,
/turf/open/floor/mainship/sterile,
/area/shuttle/canterbury/medical)
"tC" = (
/obj/structure/window/framed/mainship/white/canterbury,
/turf/open/space/basic,
/area/shuttle/canterbury/medical)
"vQ" = (
/obj/structure/shuttle/engine/propulsion/burst/left,
/turf/open/space/basic,
/area/shuttle/canterbury)
"vY" = (
/obj/machinery/vending/tool,
/obj/machinery/light{
	dir = 1
	},
/turf/open/floor/mainship/orange/full,
/area/shuttle/canterbury)
"zj" = (
/obj/structure/barricade/plasteel,
/turf/open/floor/plating/plating_catwalk,
/area/shuttle/canterbury)
"zE" = (
/obj/structure/window/framed/mainship/canterbury,
/obj/structure/cable,
/turf/open/floor/plating,
/area/shuttle/canterbury)
"zN" = (
/obj/machinery/vending/engivend,
/turf/open/floor/mainship/orange/full,
/area/shuttle/canterbury)
"Aj" = (
/obj/machinery/light,
/turf/closed/wall/mainship/outer/canterbury,
/area/shuttle/canterbury)
"Bu" = (
/obj/structure/bed/chair/dropship/passenger{
	dir = 1
	},
/obj/effect/landmark/start/job/crash/squadmarine,
/obj/machinery/light/small,
/turf/open/floor/mainship/mono,
/area/shuttle/canterbury)
"BE" = (
/obj/effect/landmark/start/job/crash/squadmarine,
/obj/structure/bed/chair/dropship/passenger{
	dir = 8
	},
/turf/open/floor/mainship/mono,
/area/shuttle/canterbury)
"BN" = (
/obj/machinery/autodoc,
/turf/open/floor/mainship/sterile,
/area/shuttle/canterbury/medical)
"Cq" = (
/obj/machinery/light{
	dir = 1
	},
/obj/machinery/vending/marineFood,
/turf/open/floor/mainship/mono,
/area/shuttle/canterbury)
"CF" = (
/obj/structure/cable,
/obj/machinery/power/terminal,
/obj/effect/turf_decal/warning_stripes/thin{
	dir = 4
	},
/turf/open/floor/mainship/tcomms,
/area/shuttle/canterbury)
"EJ" = (
/turf/open/floor/mainship/mono,
/area/shuttle/canterbury/cic)
"EP" = (
/obj/machinery/light,
/turf/open/floor/mainship/mono,
/area/shuttle/canterbury)
"GF" = (
/turf/open/floor/mainship/blue{
	dir = 1
	},
/area/shuttle/canterbury/cic)
"Hv" = (
/obj/machinery/quick_vendor/beginner,
/obj/machinery/light{
	dir = 1
	},
/turf/open/floor/mainship/cargo,
/area/shuttle/canterbury)
"Ig" = (
/obj/machinery/bot/roomba,
/turf/open/floor/mainship/mono,
/area/shuttle/canterbury)
"IW" = (
/obj/machinery/vending/uniform_supply,
/turf/open/floor/plating/plating_catwalk,
/area/shuttle/canterbury)
"KA" = (
/obj/structure/bed/chair/dropship/passenger{
	dir = 8
	},
/obj/effect/landmark/start/job/crash/squadsmartgunner,
/turf/open/floor/mainship/mono,
/area/shuttle/canterbury)
"KE" = (
/obj/effect/landmark/start/job/crash/squadmarine,
/turf/open/floor/mainship/mono,
/area/shuttle/canterbury)
"LT" = (
/obj/structure/bed/chair/dropship/passenger{
	dir = 4
	},
/obj/effect/landmark/start/job/crash/squadrobot,
/turf/open/floor/mainship/mono,
/area/shuttle/canterbury)
"Mr" = (
/obj/machinery/marine_selector/gear/robo,
/turf/open/floor/mainship/mono,
/area/shuttle/canterbury)
"Ni" = (
/obj/effect/landmark/start/job/crash/squadcorpsman,
/turf/open/floor/mainship/red,
/area/shuttle/canterbury)
"Ox" = (
/obj/machinery/marine_selector/clothes/robo,
/turf/open/floor/mainship/red/full,
/area/shuttle/canterbury)
"RS" = (
/obj/structure/cable,
/obj/effect/attach_point/crew_weapon/dropship1,
/turf/open/floor/plating/plating_catwalk,
/area/shuttle/canterbury)
"UG" = (
/obj/machinery/marine_selector/clothes/synth,
/turf/open/floor/mainship/cargo,
/area/shuttle/canterbury)
"Vf" = (
/obj/structure/window/framed/mainship/hull/canterbury,
/turf/open/space/basic,
/area/shuttle/canterbury/cic)
"Vs" = (
/obj/effect/landmark/start/job/crash/squadengineer,
/turf/open/floor/mainship/red{
	dir = 1
	},
/area/shuttle/canterbury)
"YI" = (
/obj/machinery/iv_drip,
/turf/open/floor/mainship/sterile/dark,
/area/shuttle/canterbury/medical)
"ZU" = (
/obj/structure/bed/chair/dropship/passenger{
	dir = 4
	},
/obj/effect/landmark/start/job/crash/medicalofficer,
/turf/open/floor/mainship/mono,
/area/shuttle/canterbury)

(1,1,1) = {"
aa
aa
aa
aa
aa
aa
aa
aa
an
an
an
an
an
an
an
an
an
an
an
an
an
an
"}
(2,1,1) = {"
aa
aa
aa
aa
aa
aa
aa
aa
an
pU
pU
pU
bQ
an
cd
bB
cO
cd
bu
rF
an
vQ
"}
(3,1,1) = {"
aa
aa
aa
an
an
aH
aH
aH
an
bp
bq
bq
EP
an
cz
bz
Vs
dM
Ni
bv
an
cl
"}
(4,1,1) = {"
aa
aa
aa
an
au
aF
aF
cW
an
aW
bk
pY
aR
an
cK
bO
aJ
aJ
aJ
cA
an
cm
"}
(5,1,1) = {"
aa
aa
aa
an
av
aB
aJ
Bu
an
aV
Ig
aD
bt
an
cH
sm
aJ
Ox
bD
bF
an
cm
"}
(6,1,1) = {"
ab
ac
ac
ab
ab
cV
bG
cV
an
Hv
bd
aJ
bJ
an
br
lL
aJ
Mr
bD
cE
an
cn
"}
(7,1,1) = {"
ac
ad
ai
ap
ab
cF
aJ
cR
an
cY
aJ
aJ
IW
an
Cq
bO
Ig
an
an
Aj
an
an
"}
(8,1,1) = {"
Vf
GF
EJ
lG
ab
aD
aJ
aD
ck
ZU
aD
aD
aD
LT
cp
db
aD
bV
da
KE
lC
co
"}
(9,1,1) = {"
ac
ae
aj
aq
ab
cN
aJ
aD
aD
aD
bO
aD
aD
aJ
aD
bO
aD
aD
cZ
aD
cY
co
"}
(10,1,1) = {"
ac
af
ak
ar
aw
bO
RS
bO
bO
ao
bO
bO
bO
bO
bO
RS
aJ
aJ
zj
aJ
aD
co
"}
(11,1,1) = {"
ac
ag
aj
as
ab
aL
bO
aD
aD
be
db
aD
aD
aJ
aD
db
aD
aD
cZ
aD
cY
co
"}
(12,1,1) = {"
Vf
GF
EJ
lG
ab
aD
bO
aD
KA
cc
db
aD
aD
cc
cc
db
aJ
BE
bW
aA
ex
co
"}
(13,1,1) = {"
ac
ah
am
at
ab
cP
bO
cS
an
aN
db
aD
UG
an
bA
bT
cI
cI
cI
cI
bo
an
"}
(14,1,1) = {"
ab
ac
ac
ab
ab
cQ
aO
cT
an
vY
bg
fq
bl
an
by
sJ
bK
bR
bZ
ce
bo
cl
"}
(15,1,1) = {"
aa
aa
aa
an
ax
ci
bO
cU
an
zN
cv
fq
aT
an
BN
sJ
cy
bS
ca
cf
bo
cm
"}
(16,1,1) = {"
aa
aa
aa
an
ay
aF
aF
cW
an
aR
bb
bn
zE
an
bH
sJ
cs
cJ
YI
cw
bo
cm
"}
(17,1,1) = {"
aa
aa
aa
an
an
aK
aK
aK
an
aQ
bC
bE
bj
an
bw
bI
tC
bI
bI
ka
bo
cn
"}
(18,1,1) = {"
aa
aa
aa
aa
aa
aa
aa
aa
an
aP
aZ
CF
bi
an
aC
bI
bK
bU
cb
cg
bo
vQ
"}
(19,1,1) = {"
aa
aa
aa
aa
aa
aa
aa
aa
an
an
an
an
an
an
bo
bo
bo
bo
bo
bo
bo
an
"}
